Abeska	アベスカ	Abesková	アベスコヴァー
Abík	アビーク	Abíková	アビーコヴァー
Abrahám	アブラハーム	Abrahámová	アブラハーモヴァー
Abrahamčík	アブラハムチーク	Abrahamčíková	アブラハムチーコヴァー
Abrahámek	アブラハーメク	Abrahámková	アブラハームコヴァー
Absolon	アプソロン	Absolonová	アプソロノヴァー
Adamčík	アダムチーク	Adamčíková	アダムチーコヴァー
Adamec	アダメツ	Adamcová	アダムツォヴァー
Adámek	アダーメク	Adámková	アダームコヴァー
Adamík	アダミーク	Adamíková	アダミーコヴァー
Adamovič	アダモヴィチュ	Adamovičová	アダモヴィチョヴァー
Adamovský	アダモフスキー	Adamovská	アダモフスカー
Adášek	アダーシェク	Adášková	アダーシュコヴァー
Alexa	アレクサ	Alexová	アレクソヴァー
Ambrož	アンブロシュ	Ambrožová	アンブロジョヴァー
Anděl	アンジェル	Andělová	アンジェロヴァー
Andrlík	アンドルリーク	Andrlíková	アンドルリーコヴァー
Andrš	アンドルシュ	Andršová	アンドルショヴァー
Andrýsek	アンドリーセク	Andrýsková	アンドリースコヴァー
Antoš	アントシュ	Antošová	アントショヴァー
Babák	ババーク	Babáková	ババーコヴァー
Babický	バビツキー	Babická	バビツカー
Babka	バプカ	Babková	バプコヴァー
Baborák	バボラーク	Baboráková	バボラーコヴァー
Bača	バチャ	Bačová	バチョヴァー
Báča	バーチャ	Báčová	バーチョヴァー
Bačík	バチーク	Bačíková	バチーコヴァー
Bajgar	バイガル	Bajgarová	バイガロヴァー
Bakeš	バケシュ	Bakešová	バケショヴァー
Balák	バラーク	Baláková	バラーコヴァー
Baláš	バラーシュ	Balášová	バラーショヴァー
Baláž	バラーシュ	Balážová	バラージョヴァー
Balcar	バルツァル	Balcarová	バルツァロヴァー
Balcárek	バルツァーレク	Balcárková	バルツァールコヴァー
Bálek	バーレク	Bálková	バールコヴァー
Balek	バレク	Balková	バルコヴァー
Balík	バリーク	Balíková	バリーコヴァー
Balvín	バルヴィーン	Balvínová	バルヴィーノヴァー
Baráček	バラーチェク	Baráčková	バラーチュコヴァー
Barák	バラーク	Baráková	バラーコヴァー
Baránek	バラーネク	Baránková	バラーンコヴァー
Bareš	バレシュ	Barešová	バレショヴァー
Bařina	バジナ	Bařinová	バジノヴァー
Bařinka	バジンカ	Bařinková	バジンコヴァー
Baroš	バロシュ	Barošová	バロショヴァー
Bárta	バールタ	Bártová	バールトヴァー
Barták	バルターク	Bartáková	バルターコヴァー
Bártek	バールテク	Bártková	バールトコヴァー
Bartek	バルテク	Bartková	バルトコヴァー
Bartík	バルチーク	Bartíková	バルチーコヴァー
Bartl	バルトル	Bartlová	バルトロヴァー
Bartoň	バルトン	Bartoňová	バルトニョヴァー
Bartoněk	バルトニェク	Bartoněková	バルトニェコヴァー
Bartoníček	バルトニーチェク	Bartoníčková	バルトニーチュコヴァー
Bartoš	バルトシュ	Bartošová	バルトショヴァー
Bartošek	バルトシェク	Bartošková	バルトシュコヴァー
Bartošík	バルトシーク	Bartošíková	バルトシーコヴァー
Bartůněk	バルトゥーニェク	Bartůněková	バルトゥーニェコヴァー
Bartušek	バルトゥシェク	Bartušková	バルトゥシュコヴァー
Bašta	バシュタ	Baštová	バシュトヴァー
Bastl	バストル	Bastlová	バストロヴァー
Batěk	バチェク	Batěková	バチェコヴァー
Bažant	バジャント	Bažantová	バジャントヴァー
Bečka	ベチュカ	Bečková	ベチュコヴァー
Bečvář	ベチュヴァーシュ	Bečvářová	ベチュヴァージョヴァー
Bednář	ベドナーシュ	Bednářová	ベドナージョヴァー
Bednařík	ベドナジーク	Bednaříková	ベドナジーコヴァー
Běhal	ビェハル	Běhalová	ビェハロヴァー
Běhounek	ビェホウネク	Běhounková	ビェホウンコヴァー
Bejček	ベイチェク	Bejčková	ベイチュコヴァー
Bělík	ビェリーク	Bělíková	ビェリーコヴァー
Bělka	ビェルカ	Bělková	ビェルコヴァー
Bělohlávek	ビェロフラーヴェク	Bělohlávková	ビェロフラーフコヴァー
Bém	ベーム	Bémová	ベーモヴァー
Benák	ベナーク	Benáková	ベナーコヴァー
Bendík	ベンディーク	Bendíková	ベンディーコヴァー
Beneš	ベネシュ	Benešová	ベネショヴァー
Benešov	ベネショフ	Benešovová	ベネショヴォヴァー
Beníšek	ベニーシェク	Beníšková	ベニーシュコヴァー
Beránek	ベラーネク	Beránková	ベラーンコヴァー
Berdych	ベルディフ	Berdychová	ベルディホヴァー
Berka	ベルカ	Berková	ベルコヴァー
Berky	ベルキ	Berkyová	ベルキオヴァー
Bernášek	ベルナーシェク	Bernášková	ベルナーシュコヴァー
Bezděk	ベズジェク	Bezděková	ベズジェコヴァー
Bezdíček	ベズディーチェク	Bezdíčková	ベズディーチュコヴァー
Bílek	ビーレク	Bílková	ビールコヴァー
Bilík	ビリーク	Bilíková	ビリーコヴァー
Bílý	ビーリー	Bílá	ビーラー
Bína	ビーナ	Bínová	ビーノヴァー
Bláha	ブラーハ	Bláhová	ブラーホヴァー
Blahuta	ブラフタ	Blahutová	ブラフトヴァー
Blažej	ブラジェイ	Blažejová	ブラジェヨヴァー
Blažek	ブラジェク	Blažková	ブラシュコヴァー
Bobek	ボベク	Bobková	ボプコヴァー
Boček	ボチェク	Bočková	ボチュコヴァー
Bocek	ボツェク	Bocková	ボツコヴァー
Bodlák	ボドラーク	Bodláková	ボドラーコヴァー
Boháč	ボハーチュ	Boháčová	ボハーチョヴァー
Boháček	ボハーチェク	Boháčková	ボハーチュコヴァー
Bohata	ボハタ	Bohatová	ボハトヴァー
Bohatý	ボハティー	Bohatá	ボハター
Bohuslav	ボフスラフ	Bohuslavová	ボフスラヴォヴァー
Bolek	ボレク	Bolková	ボルコヴァー
Borák	ボラーク	Boráková	ボラーコヴァー
Borecký	ボレツキー	Borecká	ボレツカー
Borek	ボレク	Borková	ボルコヴァー
Bořil	ボジル	Bořilová	ボジロヴァー
Borovec	ボロヴェツ	Borovcová	ボロヴツォヴァー
Borovička	ボロヴィチュカ	Borovičková	ボロヴィチュコヴァー
Borovka	ボロフカ	Borovková	ボロフコヴァー
Borovský	ボロフスキー	Borovská	ボロフスカー
Borský	ボルスキー	Borská	ボルスカー
Borůvka	ボルーフカ	Borůvková	ボルーフコヴァー
Bosák	ボサーク	Bosáková	ボサーコヴァー
Bošek	ボシェク	Bošková	ボシュコヴァー
Botek	ボテク	Botková	ボトコヴァー
Bouček	ボウチェク	Boučková	ボウチュコヴァー
Bouda	ボウダ	Boudová	ボウドヴァー
Bouška	ボウシュカ	Boušková	ボウシュコヴァー
Bouzek	ボウゼク	Bouzková	ボウスコヴァー
Božek	ボジェク	Božková	ボシュコヴァー
Brabec	ブラベツ	Brabcová	ブラブツォヴァー
Brabenec	ブラベネツ	Brabencová	ブラベンツォヴァー
Brada	ブラダ	Bradová	ブラドヴァー
Bradáč	ブラダーチュ	Bradáčová	ブラダーチョヴァー
Bravenec	ブラヴェネツ	Bravencová	ブラヴェンツォヴァー
Brázda	ブラーズダ	Brázdová	ブラーズドヴァー
Brázdil	ブラーズディル	Brázdilová	ブラーズディロヴァー
Břečka	ブシェチュカ	Břečková	ブシェチュコヴァー
Brejcha	ブレイハ	Brejchová	ブレイホヴァー
Březina	ブシェズィナ	Březinová	ブシェズィノヴァー
Břicháček	ブシハーチェク	Břicháčková	ブシハーチュコヴァー
Bříza	ブシーザ	Břízová	ブシーゾヴァー
Brodský	ブロツキー	Brodská	ブロツカー
Brokeš	ブロケシュ	Brokešová	ブロケショヴァー
Brouček	ブロウチェク	Broučková	ブロウチュコヴァー
Brož	ブロシュ	Brožová	ブロジョヴァー
Brožek	ブロジェク	Brožková	ブロシュコヴァー
Brožík	ブロジーク	Brožíková	ブロジーコヴァー
Brůha	ブルーハ	Brůhová	ブルーホヴァー
Brunclík	ブルンツリーク	Brunclíková	ブルンツリーコヴァー
Brůžek	ブルージェク	Brůžková	ブルーシュコヴァー
Brzák	ブルザーク	Brzáková	ブルザーコヴァー
Brzobohatý	ブルゾボハティー	Brzobohatá	ブルゾボハター
Bubeníček	ブベニーチェク	Bubeníčková	ブベニーチュコヴァー
Bubeník	ブベニーク	Bubeníková	ブベニーコヴァー
Bublík	ブブリーク	Bublíková	ブブリーコヴァー
Buček	ブチェク	Bučková	ブチュコヴァー
Buchta	ブフタ	Buchtová	ブフトヴァー
Budík	ブディーク	Budíková	ブディーコヴァー
Budín	ブディーン	Budínová	ブディーノヴァー
Budinský	ブディンスキー	Budinská	ブディンスカー
Budský	ブツキー	Budská	ブツカー
Bukáček	ブカーチェク	Bukáčková	ブカーチュコヴァー
Bukovský	ブコフスキー	Bukovská	ブコフスカー
Bulíček	ブリーチェク	Bulíčková	ブリーチュコヴァー
Bulín	ブリーン	Bulínová	ブリーノヴァー
Burda	ブルダ	Burdová	ブルドヴァー
Bureš	ブレシュ	Burešová	ブレショヴァー
Buriánek	ブリアーネク	Buriánková	ブリアーンコヴァー
Buřič	ブジチュ	Buřičová	ブジチョヴァー
Bursa	ブルサ	Bursová	ブルソヴァー
Buršík	ブルシーク	Buršíková	ブルシーコヴァー
Bursík	ブルシーク	Bursíková	ブルシーコヴァー
Bušek	ブシェク	Bušková	ブシュコヴァー
Bůžek	ブージェク	Bůžková	ブーシュコヴァー
Buzek	ブゼク	Buzková	ブスコヴァー
Bydžovský	ビドジョフスキー	Bydžovská	ビドジョフスカー
Byrtus	ビルトゥス	Byrtusová	ビルトゥソヴァー
Bystřický	ビスッチツキー	Bystřická	ビスッチツカー
Bystroň	ビストロン	Bystroňová	ビストロニョヴァー
Čada	チャダ	Čadová	チャドヴァー
Čadek	チャデク	Čadková	チャトコヴァー
Caha	ツァハ	Cahová	ツァホヴァー
Čajka	チャイカ	Čajková	チャイコヴァー
Caletka	ツァレトカ	Caletková	ツァレトコヴァー
Čáp	チャープ	Čápová	チャーポヴァー
Čapek	チャペック、チャペク	Čapková	チャプコヴァー
Čapka	チャプカ	Čapková	チャプコヴァー
Carda	ツァルダ	Cardová	ツァルドヴァー
Čáslavský	チャースラフスキー	Čáslavská	チャースラフスカー
Částka	チャーストカ	Částková	チャーストコヴァー
Čech	チェフ	Čechová	チェホヴァー
Čechák	チェハーク	Čecháková	チェハーコヴァー
Čechura	チェフラ	Čechurová	チェフロヴァー
Čejka	チェイカ	Čejková	チェイコヴァー
Cejpek	ツェイペク	Cejpková	ツェイプコヴァー
Čekal	チェカル	Čekalová	チェカロヴァー
Čelůstka	チェルーストカ	Čelůstková	チェルーストコヴァー
Čepek	チェペク	Čepková	チェプコヴァー
Čepelák	チェペラーク	Čepeláková	チェペラーコヴァー
Čermák	チェルマーク	Čermáková	チェルマーコヴァー
Černík	チェルニーク	Černíková	チェルニーコヴァー
Černoch	チェルノフ	Černochová	チェルノホヴァー
Černohorský	チェルノホルスキー	Černohorská	チェルノホルスカー
Černošek	チェルノシェク	Černošková	チェルノシュコヴァー
Černý	チェルニー	Černá	チェルナー
Čeřovský	チェジョフスキー	Čeřovská	チェジョフスカー
Červeňák	チェルヴェニャーク	Červeňáková	チェルヴェニャーコヴァー
Červenka	チェルヴェンカ	Červenková	チェルヴェンコヴァー
Červený	チェルヴェニー	Červená	チェルヴェナー
Červinka	チェルヴィンカ	Červinková	チェルヴィンコヴァー
Češka	チェシュカ	Češková	チェシュコヴァー
Čevela	チェヴェラ	Čevelová	チェヴェロヴァー
Chadima	ハディマ	Chadimová	ハディモヴァー
Chaloupka	ハロウプカ	Chaloupková	ハロウプコヴァー
Charvát	ハルヴァート	Charvátová	ハルヴァートヴァー
Chládek	フラーデク	Chládková	フラートコヴァー
Chlumský	フルムスキー	Chlumská	フルムスカー
Chlup	フルプ	Chlupová	フルポヴァー
Chmel	フメル	Chmelová	フメロヴァー
Chmela	フメラ	Chmelová	フメロヴァー
Chmelař	フメラシュ	Chmelařová	フメラジョヴァー
Chmelíček	フメリーチェク	Chmelíčková	フメリーチュコヴァー
Chmelík	フメリーク	Chmelíková	フメリーコヴァー
Chocholouš	ホホロウシュ	Chocholoušová	ホホロウショヴァー
Chovanec	ホヴァネツ	Chovancová	ホヴァンツォヴァー
Chrástek	フラーステク	Chrástková	フラーストコヴァー
Chromý	フロミー	Chromá	フロマー
Chudoba	フドバ	Chudobová	フドボヴァー
Chudý	フディー	Chudá	フダー
Chvála	フヴァーラ	Chválová	フヴァーロヴァー
Chvátal	フヴァータル	Chvátalová	フヴァータロヴァー
Chvojka	フヴォイカ	Chvojková	フヴォイコヴァー
Chytil	ヒチル	Chytilová	ヒチロヴァー
Cibulka	ツィブルカ	Cibulková	ツィブルコヴァー
Cigánek	ツィガーネク	Cigánková	ツィガーンコヴァー
Čihák	チハーク	Čiháková	チハーコヴァー
Číhal	チーハル	Číhalová	チーハロヴァー
Cihlář	ツィフラーシュ	Cihlářová	ツィフラージョヴァー
Čipera	チペラ	Čiperová	チペロヴァー
Císař	ツィーサシュ	Císařová	ツィーサジョヴァー
Číž	チーシュ	Čížová	チージョヴァー
Čížek	チージェク	Čížková	チーシュコヴァー
Crha	ツルハ	Crhová	ツルホヴァー
Čtvrtečka	チュトヴルテチュカ	Čtvrtečková	チュトヴルテチュコヴァー
Čtvrtník	チュトヴルトニーク	Čtvrtníková	チュトヴルトニーコヴァー
Čuda	チュダ	Čudová	チュドヴァー
Culek	ツレク	Culková	ツルコヴァー
Čurda	チュルダ	Čurdová	チュルドヴァー
Čureja	チュレヤ	Čurejová	チュレヨヴァー
Cvrček	ツヴルチェク	Cvrčková	ツヴルチュコヴァー
Daněk	ダニェク	Daněková	ダニェコヴァー
Daňhel	ダンヘル	Daňhelová	ダンヘロヴァー
Daníček	ダニーチェク	Daníčková	ダニーチュコヴァー
Danihel	ダニヘル	Danihelová	ダニヘロヴァー
Daniš	ダニシュ	Danišová	ダニショヴァー
Davídek	ダヴィーデク	Davídková	ダヴィートコヴァー
Dědek	ジェデク	Dědková	ジェトコヴァー
Dedek	デデク	Dedková	デトコヴァー
Dědič	ジェディチュ	Dědičová	ジェディチョヴァー
Dejmek	デイメク	Dejmková	デイムコヴァー
Demeter	デメテル	Demeterová	デメテロヴァー
Diblík	ディブリーク	Diblíková	ディブリーコヴァー
Dítě	ディーチェ	Dítětová	ディーチェトヴァー
Diviš	ディヴィシュ	Divišová	ディヴィショヴァー
Dlouhý	ドロウヒー	Dlouhá	ドロウハー
Dluhoš	ドルホシュ	Dluhošová	ドルホショヴァー
Dobeš	ドベシュ	Dobešová	ドベショヴァー
Dobiáš	ドビアーシュ	Dobiášová	ドビアーショヴァー
Dobrovolný	ドブロヴォルニー	Dobrovolná	ドブロヴォルナー
Dobrý	ドブリー	Dobrá	ドブラー
Dočekal	ドチェカル	Dočekalová	ドチェカロヴァー
Dočkal	ドチュカル	Dočkalová	ドチュカロヴァー
Dohnal	ドフナル	Dohnalová	ドフナロヴァー
Dohnálek	ドフナーレク	Dohnálková	ドフナールコヴァー
Dokoupil	ドコウピル	Dokoupilová	ドコウピロヴァー
Dolák	ドラーク	Doláková	ドラーコヴァー
Dolanský	ドランスキー	Dolanská	ドランスカー
Doleček	ドレチェク	Dolečková	ドレチュコヴァー
Dolejš	ドレイシュ	Dolejšová	ドレイショヴァー
Dolejší	ドレイシー	Dolejší	ドレイシー
Doležal	ドレジャル	Doležalová	ドレジャロヴァー
Doležel	ドレジェル	Doleželová	ドレジェロヴァー
Donát	ドナート	Donátová	ドナートヴァー
Dopita	ドピタ	Dopitová	ドピトヴァー
Dorazil	ドラズィル	Dorazilová	ドラズィロヴァー
Dorňák	ドルニャーク	Dorňáková	ドルニャーコヴァー
Doseděl	ドセジェル	Dosedělová	ドセジェロヴァー
Došek	ドシェク	Došková	ドシュコヴァー
Doskočil	ドスコチル	Doskočilová	ドスコチロヴァー
Dostál	ドスタール	Dostálová	ドスターロヴァー
Dostálek	ドスターレク	Dostálková	ドスタールコヴァー
Doubek	ドウベク	Doubková	ドウプコヴァー
Doubrava	ドウブラヴァ	Doubravová	ドウブラヴォヴァー
Doubravský	ドウブラフスキー	Doubravská	ドウブラフスカー
Douda	ドウダ	Doudová	ドウドヴァー
Douša	ドウシャ	Doušová	ドウショヴァー
Dráb	ドラープ	Drábová	ドラーボヴァー
Drábek	ドラーベク	Drábková	ドラープコヴァー
Dragoun	ドラゴウン	Dragounová	ドラゴウノヴァー
Drahoňovský	ドラホニョフスキー	Drahoňovská	ドラホニョフスカー
Drahoš	ドラホシュ	Drahošová	ドラホショヴァー
Drapák	ドラパーク	Drapáková	ドラパーコヴァー
Drápal	ドラーパル	Drápalová	ドラーパロヴァー
Drápela	ドラーペラ	Drápelová	ドラーペロヴァー
Drbohlav	ドルボフラフ	Drbohlavová	ドルボフラヴォヴァー
Drda	ドルダ	Drdová	ドルドヴァー
Drexler	ドレクスレル	Drexlerová	ドレクスレロヴァー
Dřímal	ドジーマル	Dřímalová	ドジーマロヴァー
Drlík	ドルリーク	Drlíková	ドルリーコヴァー
Drobný	ドロブニー	Drobná	ドロブナー
Drtikol	ドルチコル	Drtikolová	ドルチコロヴァー
Dubec	ドゥベツ	Dubcová	ドゥブツォヴァー
Dubský	ドゥプスキー	Dubská	ドゥプスカー
Ducháček	ドゥハーチェク	Ducháčková	ドゥハーチュコヴァー
Duchek	ドゥヘク	Duchková	ドゥフコヴァー
Duchoň	ドゥホン	Duchoňová	ドゥホニョヴァー
Dudek	ドゥデク	Dudková	ドゥトコヴァー
Dufek	ドゥフェク	Dufková	ドゥフコヴァー
Dunka	ドゥンカ	Dunková	ドゥンコヴァー
Dušek	ドゥシェク	Dušková	ドゥシュコヴァー
Dušík	ドゥシーク	Dušíková	ドゥシーコヴァー
Dvořáček	ドヴォジャーチェク	Dvořáčková	ドヴォジャーチュコヴァー
Dvořák	ドヴォジャーク（ドヴォルザーク）	Dvořáková	ドヴォジャーコヴァー
Dvorský	ドヴォルスキー	Dvorská	ドヴォルスカー
Eliáš	エリアーシュ	Eliášová	エリアーショヴァー
Fabián	ファビアーン	Fabiánová	ファビアーノヴァー
Fabiánek	ファビアーネク	Fabiánková	ファビアーンコヴァー
Fabík	ファビーク	Fabíková	ファビーコヴァー
Falta	ファルタ	Faltová	ファルトヴァー
Faltýnek	ファルティーネク	Faltýnková	ファルティーンコヴァー
Farkaš	ファルカシュ	Farkašová	ファルカショヴァー
Farský	ファルスキー	Farská	ファルスカー
Fedák	フェダーク	Fedáková	フェダーコヴァー
Fejfar	フェイファル	Fejfarová	フェイファロヴァー
Fencl	フェンツル	Fenclová	フェンツロヴァー
Ferenc	フェレンツ	Ferencová	フェレンツォヴァー
Fiala	フィアラ	Fialová	フィアロヴァー
Fialka	フィアルカ	Fialková	フィアルコヴァー
Fibich	フィビフ	Fibichová	フィビホヴァー
Ficek	フィツェク	Ficková	フィツコヴァー
Filák	フィラーク	Filáková	フィラーコヴァー
Filip	フィリプ	Filipová	フィリポヴァー
Filípek	フィリーペク	Filípková	フィリープコヴァー
Fišar	フィシャル	Fišarová	フィシャロヴァー
Fišer	フィシェル	Fišerová	フィシェロヴァー
Fišera	フィシェラ	Fišerová	フィシェロヴァー
Flachs	フラフス	Flachsová	フラフソヴァー
Flek	フレク	Flková	フルコヴァー
Flídr	フリードル	Flídrová	フリードロヴァー
Florián	フロリアーン	Floriánová	フロリアーノヴァー
Florian	フロリアン	Florianová	フロリアノヴァー
Fojt	フォイト	Fojtová	フォイトヴァー
Fojtík	フォイチーク	Fojtíková	フォイチーコヴァー
Fojtů	フォイトゥー	Fojtů	フォイトゥー
Folta	フォルタ	Foltová	フォルトヴァー
Foltýn	フォルティーン	Foltýnová	フォルティーノヴァー
Formánek	フォルマーネク	Formánková	フォルマーンコヴァー
Fořt	フォジュト	Fořtová	フォジュトヴァー
Fousek	フォウセク	Fousková	フォウスコヴァー
Franek	フラネク	Franková	フランコヴァー
Franěk	フラニェク	Franěková	フラニェコヴァー
Franta	フランタ	Frantová	フラントヴァー
Frič	フリチュ	Fričová	フリチョヴァー
Fric	フリツ	Fricová	フリツォヴァー
Frolík	フロリーク	Frolíková	フロリーコヴァー
Froněk	フロニェク	Froněková	フロニェコヴァー
Fryč	フリチュ	Fryčová	フリチョヴァー
Frýdl	フリードル	Frýdlová	フリードロヴァー
Frydrych	フリドリフ	Frydrychová	フリドリホヴァー
Fučík	フチーク	Fučíková	フチーコヴァー
Fulín	フリーン	Fulínová	フリーノヴァー
Fusek	フセク	Fusková	フスコヴァー
Gábor	ガーボル	Gáborová	ガーボロヴァー
Gajda	ガイダ	Gajdová	ガイドヴァー
Gajdoš	ガイドシュ	Gajdošová	ガイドショヴァー
Gajdošík	ガイドシーク	Gajdošíková	ガイドシーコヴァー
Gál	ガール	Gálová	ガーロヴァー
Gašpar	ガシュパル	Gašparová	ガシュパロヴァー
Gazdík	ガズディーク	Gazdíková	ガズディーコヴァー
Gaži	ガジ	Gažiová	ガジオヴァー
Gregor	グレゴル	Gregorová	グレゴロヴァー
Grepl	グレプル	Greplová	グレプロヴァー
Grošek	グロシェク	Grošková	グロシュコヴァー
Hadač	ハダチュ	Hadačová	ハダチョヴァー
Hadrava	ハドラヴァ	Hadravová	ハドラヴォヴァー
Hájek	ハーイエク	Hájková	ハーイコヴァー
Hajný	ハイニー	Hajná	ハイナー
Hák	ハーク	Háková	ハーコヴァー
Hakl	ハクル	Haklová	ハクロヴァー
Hála	ハーラ	Hálová	ハーロヴァー
Halama	ハラマ	Halamová	ハラモヴァー
Halík	ハリーク	Halíková	ハリーコヴァー
Halíř	ハリーシュ	Halířová	ハリージョヴァー
Halouzka	ハロウスカ	Halouzková	ハロウスコヴァー
Haluška	ハルシュカ	Halušková	ハルシュコヴァー
Haluza	ハルザ	Haluzová	ハルゾヴァー
Hamáček	ハマーチェク	Hamáčková	ハマーチュコヴァー
Hamerník	ハメルニーク	Hamerníková	ハメルニーコヴァー
Hána	ハーナ	Hánová	ハーノヴァー
Hanáček	ハナーチェク	Hanáčková	ハナーチュコヴァー
Hanák	ハナーク	Hanáková	ハナーコヴァー
Handl	ハンドル	Handlová	ハンドロヴァー
Hanko	ハンコ	Hanková	ハンコヴァー
Hanousek	ハノウセク	Hanousková	ハノウスコヴァー
Hanus	ハヌス	Hanusová	ハヌソヴァー
Hanuš	ハヌシュ	Hanušová	ハヌショヴァー
Hanzelka	ハンゼルカ	Hanzelková	ハンゼルコヴァー
Hanzlíček	ハンズリーチェク	Hanzlíčková	ハンズリーチュコヴァー
Hanzlík	ハンズリーク	Hanzlíková	ハンズリーコヴァー
Hartl	ハルトル	Hartlová	ハルトロヴァー
Hašek	ハシェク	Hašková	ハシュコヴァー
Havel	ハヴェル	Havelová	ハヴェロヴァー
Havelka	ハヴェルカ	Havelková	ハヴェルコヴァー
Havlíček	ハヴリーチェク	Havlíčková	ハヴリーチュコヴァー
Havlík	ハヴリーク	Havlíková	ハヴリーコヴァー
Havlín	ハヴリーン	Havlínová	ハヴリーノヴァー
Havran	ハヴラン	Havranová	ハヴラノヴァー
Havránek	ハヴラーネク	Havránková	ハヴラーンコヴァー
Havrda	ハヴルダ	Havrdová	ハヴルドヴァー
Hečko	ヘチュコ	Hečková	ヘチュコヴァー
Hejda	ヘイダ	Hejdová	ヘイドヴァー
Hejduk	ヘイドゥク、ヘイドゥック	Hejduková	ヘイドゥコヴァー、ヘイドゥッコヴァー
Hejl	ヘイル	Hejlová	ヘイロヴァー
Hejna	ヘイナ	Hejnová	ヘイノヴァー
Hejný	ヘイニー	Hejná	ヘイナー
Hejtmánek	ヘイトマーネク	Hejtmánková	ヘイトマーンコヴァー
Helešic	ヘレシツ	Helešicová	ヘレシツォヴァー
Heller	ヘッレル	Hellerová	ヘッレロヴァー
Hendrych	ヘンドリフ	Hendrychová	ヘンドリホヴァー
Henzl	ヘンズル	Henzlová	ヘンズロヴァー
Herák	ヘラーク	Heráková	ヘラーコヴァー
Hercík	ヘルツィーク	Hercíková	ヘルツィーコヴァー
Heřman	ヘジュマン	Heřmanová	ヘジュマノヴァー
Heřmánek	ヘジュマーネク	Heřmánková	ヘジュマーンコヴァー
Herzán	ヘルザーン	Herzánová	ヘルザーノヴァー
Hladík	ハラディーク	Hladíková	ハラディーコヴァー
Hladký	ハラトキー	Hladká	ハラトカー
Hlava	ハラヴァ	Hlavová	ハラヴォヴァー
Hlaváč	ハラヴァーチュ	Hlaváčová	ハラヴァーチョヴァー
Hlavač	ハラヴァチュ	Hlavačová	ハラヴァチョヴァー
Hlaváček	ハラヴァーチェク	Hlaváčková	ハラヴァーチュコヴァー
Hlavaček	ハラヴァチェク	Hlavačková	ハラヴァチュコヴァー
Hlavatý	ハラヴァティー	Hlavatá	ハラヴァター
Hlavica	ハラヴィツァ	Hlavicová	ハラヴィツォヴァー
Hlavička	ハラヴィチュカ	Hlavičková	ハラヴィチュコヴァー
Hlavinka	ハラヴィンカ	Hlavinková	ハラヴィンコヴァー
Hlávka	ハラーフカ	Hlávková	ハラーフコヴァー
Hlavnička	ハラヴニチュカ	Hlavničková	ハラヴニチュコヴァー
Hlavsa	ハラフサ	Hlavsová	ハラフソヴァー
Hlinka	ハリンカ	Hlinková	ハリンコヴァー
Hloušek	ハロウシェク	Hloušková	ハロウシュコヴァー
Hložek	ハロジェク	Hložková	ハロシュコヴァー
Hlubuček	ハルブチェク	Hlubučková	ハルブチュコヴァー
Hnát	ハナート	Hnátová	ハナートヴァー
Hnátek	ハナーテク	Hnátková	ハナートコヴァー
Hnilička	ハニリチュカ	Hniličková	ハニリチュコヴァー
Hnízdil	ハニーズディル	Hnízdilová	ハニーズディロヴァー
Hodek	ホデク	Hodková	ホトコヴァー
Hofírek	ホフィーレク	Hofírková	ホフィールコヴァー
Holásek	ホラーセク	Holásková	ホラースコヴァー
Holčák	ホルチャーク	Holčáková	ホルチャーコヴァー
Holec	ホレツ	Holcová	ホルツォヴァー
Holeček	ホレチェク	Holečková	ホレチュコヴァー
Holek	ホレク	Holková	ホルコヴァー
Holeš	ホレシュ	Holešová	ホレショヴァー
Holický	ホリツキー	Holická	ホリツカー
Holík	ホリーク	Holíková	ホリーコヴァー
Holinka	ホリンカ	Holinková	ホリンコヴァー
Holiš	ホリシュ	Holišová	ホリショヴァー
Holomek	ホロメク	Holomková	ホロムコヴァー
Holoubek	ホロウベク	Holoubková	ホロウプコヴァー
Holub	ホルプ	Holubová	ホルボヴァー
Holubec	ホルベツ	Holubcová	ホルブツォヴァー
Holuša	ホルシャ	Holušová	ホルショヴァー
Holý	ホリー	Holá	ホラー
Honzík	ホンズィーク	Honzíková	ホンズィーコヴァー
Horaček	ホラチェク	Horačková	ホラチュコヴァー
Horáček	ホラーチェク	Horáčková	ホラーチュコヴァー
Horák	ホラーク	Horáková	ホラーコヴァー
Hořák	ホジャーク	Hořáková	ホジャーコヴァー
Horálek	ホラーレク	Horálková	ホラールコヴァー
Horčička	ホルチチュカ	Horčičková	ホルチチュコヴァー
Hořejší	ホジェイシー	Hořejší	ホジェイシー
Hořínek	ホジーネク	Hořínková	ホジーンコヴァー
Horký	ホルキー	Horká	ホルカー
Horňák	ホルニャーク	Horňáková	ホルニャーコヴァー
Horníček	ホルニーチェク	Horníčková	ホルニーチュコヴァー
Horník	ホルニーク	Horníková	ホルニーコヴァー
Horský	ホルスキー	Horská	ホルスカー
Horvát	ホルヴァート	Horvátová	ホルヴァートヴァー
Horyna	ホリナ	Horynová	ホリノヴァー
Hošek	ホシェク	Hošková	ホシュコヴァー
Hotárek	ホターレク	Hotárková	ホタールコヴァー
Hotový	ホトヴィー	Hotová	ホトヴァー
Houdek	ホウデク	Houdková	ホウトコヴァー
Houska	ホウスカ	Housková	ホウスコヴァー
Houška	ホウシュカ	Houšková	ホウシュコヴァー
Houžvička	ホウジュヴィチュカ	Houžvičková	ホウジュヴィチュコヴァー
Hovorka	ホヴォルカ	Hovorková	ホヴォルコヴァー
Hozák	ホザーク	Hozáková	ホザーコヴァー
Hrabák	ハラバーク	Hrabáková	ハラバーコヴァー
Hrabal	ハラバル	Hrabalová	ハラバロヴァー
Hrabánek	ハラバーネク	Hrabánková	ハラバーンコヴァー
Hrabě	ハラビェ	Hrabětová	ハラビェトヴァー
Hrabec	ハラベツ	Hrabcová	ハラブツォヴァー
Hrabovský	ハラボフスキー	Hrabovská	ハラボフスカー
Hrachovec	ハラホヴェツ	Hrachovcová	ハラホヴツォヴァー
Hradecký	ハラデツキー	Hradecká	ハラデツカー
Hrádek	ハラーデク	Hrádková	ハラートコヴァー
Hradil	ハラディル	Hradilová	ハラディロヴァー
Hradský	ハラツキー	Hradská	ハラツカー
Hrazdil	ハラズディル	Hrazdilová	ハラズディロヴァー
Hrbáč	ハルバーチュ	Hrbáčová	ハルバーチョヴァー
Hrbáček	ハルバーチェク	Hrbáčková	ハルバーチュコヴァー
Hrbek	ハルベク	Hrbková	ハルプコヴァー
Hrdina	ハルディナ	Hrdinová	ハルディノヴァー
Hrdlička	ハルドリチュカ	Hrdličková	ハルドリチュコヴァー
Hrdý	ハルディー	Hrdá	ハルダー
Hřebíček	ハジェビーチェク	Hřebíčková	ハジェビーチュコヴァー
Hrnčíř	ハルンチーシュ	Hrnčířová	ハルンチージョヴァー
Hroch	ハロフ	Hrochová	ハロホヴァー
Hromada	ハロマダ	Hromadová	ハロマドヴァー
Hromádka	ハロマートカ	Hromádková	ハロマートコヴァー
Hromek	ハロメク	Hromková	ハロムコヴァー
Hron	ハロン	Hronová	ハロノヴァー
Hronek	ハロネク	Hronková	ハロンコヴァー
Hrouda	ハロウダ	Hroudová	ハロウドヴァー
Hrstka	ハルストカ	Hrstková	ハルストコヴァー
Hrubeš	ハルベシュ	Hrubešová	ハルベショヴァー
Hrubý	ハルビー	Hrubá	ハルバー
Hruška	ハルシュカ	Hrušková	ハルシュコヴァー
Hrůza	ハルーザ	Hrůzová	ハルーゾヴァー
Hubáček	フバーチェク	Hubáčková	フバーチュコヴァー
Hubálek	フバーレク	Hubálková	フバールコヴァー
Hubený	フベニー	Hubená	フベナー
Hubka	フプカ	Hubková	フプコヴァー
Hudák	フダーク	Hudáková	フダーコヴァー
Hudec	フデツ	Hudcová	フドツォヴァー
Hudeček	フデチェク	Hudečková	フデチュコヴァー
Hůla	フーラ	Hůlová	フーロヴァー
Hůlka	フールカ	Hůlková	フールコヴァー
Huml	フムル	Humlová	フムロヴァー
Hůrka	フールカ	Hůrková	フールコヴァー
Hurta	フルタ	Hurtová	フルトヴァー
Husák	フサーク	Husáková	フサーコヴァー
Husár	フサール	Husárová	フサーロヴァー
Hušek	フシェク	Hušková	フシュコヴァー
Hvězda	ハヴェズダ	Hvězdová	ハヴェズドヴァー
Hynek	ヒネク	Hynková	ヒンコヴァー
Hýsek	ヒーセク	Hýsková	ヒースコヴァー
Indra	インドラ	Indrová	インドロヴァー
Indrák	インドラーク	Indráková	インドラーコヴァー
Jabůrek	ヤブーレク	Jabůrková	ヤブールコヴァー
Jadrný	ヤドルニー	Jadrná	ヤドルナー
Jagoš	ヤゴシュ	Jagošová	ヤゴショヴァー
Jahoda	ヤホダ	Jahodová	ヤホドヴァー
Jakeš	ヤケシュ	Jakešová	ヤケショヴァー
Jakl	ヤクル	Jaklová	ヤクロヴァー
Jákl	ヤークル	Jáklová	ヤークロヴァー
Jakoubek	ヤコウベク	Jakoubková	ヤコウプコヴァー
Jakubec	ヤクベツ	Jakubcová	ヤクブツォヴァー
Jakubík	ヤクビーク	Jakubíková	ヤクビーコヴァー
Jalůvka	ヤルーフカ	Jalůvková	ヤルーフコヴァー
Janáč	ヤナーチュ	Janáčová	ヤナーチョヴァー
Janáček	ヤナーチェク	Janáčková	ヤナーチュコヴァー
Janák	ヤナーク	Janáková	ヤナーコヴァー
Janata	ヤナタ	Janatová	ヤナトヴァー
Janča	ヤンチャ	Jančová	ヤンチョヴァー
Jančík	ヤンチーク	Jančíková	ヤンチーコヴァー
Janda	ヤンダ	Jandová	ヤンドヴァー
Jandaček	ヤンダチェク	Jandačková	ヤンダチュコヴァー
Jandík	ヤンディーク	Jandíková	ヤンディーコヴァー
Janeček	ヤネチェク	Janečková	ヤネチュコヴァー
Janečka	ヤネチュカ	Janečková	ヤネチュコヴァー
Janek	ヤネク	Janková	ヤンコヴァー
Janiček	ヤニチェク	Janičková	ヤニチュコヴァー
Janíček	ヤニーチェク	Janíčková	ヤニーチュコヴァー
Janík	ヤニーク	Janíková	ヤニーコヴァー
Janiš	ヤニシュ	Janišová	ヤニショヴァー
Jankovič	ヤンコヴィチュ	Jankovičová	ヤンコヴィチョヴァー
Jankovský	ヤンコフスキー	Jankovská	ヤンコフスカー
Janků	ヤンクー	Janků	ヤンクー
Janoš	ヤノシュ	Janošová	ヤノショヴァー
Janošek	ヤノシェク	Janošková	ヤノシュコヴァー
Janošík	ヤノシーク	Janošíková	ヤノシーコヴァー
Janota	ヤノタ	Janotová	ヤノトヴァー
Janouch	ヤノウフ	Janouchová	ヤノウホヴァー
Janouš	ヤノウシュ	Janoušová	ヤノウショヴァー
Janoušek	ヤノウシェク	Janoušková	ヤノウシュコヴァー
Janovský	ヤノフスキー	Janovská	ヤノフスカー
Jánský	ヤーンスキー	Jánská	ヤーンスカー
Janský	ヤンスキー	Janská	ヤンスカー
Janů	ヤヌー	Janů	ヤヌー
Januš	ヤヌシュ	Janušová	ヤヌショヴァー
Jareš	ヤレシュ	Jarešová	ヤレショヴァー
Jarkovský	ヤルコフスキー	Jarkovská	ヤルコフスカー
Jarolím	ヤロリーム	Jarolímová	ヤロリーモヴァー
Jarolímek	ヤロリーメク	Jarolímková	ヤロリームコヴァー
Jaroš	ヤロシュ	Jarošová	ヤロショヴァー
Jarošík	ヤロシーク	Jarošíková	ヤロシーコヴァー
Jarý	ヤリー	Jará	ヤラー
Jašek	ヤシェク	Jašková	ヤシュコヴァー
Javorský	ヤヴォルスキー	Javorská	ヤヴォルスカー
Javůrek	ヤヴーレク	Javůrková	ヤヴールコヴァー
Jebavý	イエバヴィー	Jebavá	イエバヴァー
Jech	イエフ	Jechová	イエホヴァー
Jedlička	イエドリチュカ、イェドリチュカ	Jedličková	イエドリチュコヴァー、イェドリチュコヴァー
Jehlička	イエフリチュカ	Jehličková	イエフリチュコヴァー
Jelínek	イエリーネク	Jelínková	イエリーンコヴァー
Jemelka	イエメルカ	Jemelková	イエメルコヴァー
Jeníček	イエニーチェク	Jeníčková	イエニーチュコヴァー
Jeník	イエニーク	Jeníková	イエニーコヴァー
Jeřábek	イエジャーベク	Jeřábková	イエジャープコヴァー
Jeremiáš	イェレミアーシュ	Jeremiášová	イェレミアーショヴァー
Jež	イエシュ	Ježová	イエジョヴァー
Ježek	イエジェク	Ježková	イエシュコヴァー
Jícha	イーハ	Jíchová	イーホヴァー
Jílek	イーレク	Jílková	イールコヴァー
Jindra	インドラ	Jindrová	インドロヴァー
Jindřich	インドジフ	Jindřichová	インドジホヴァー
Jíra	イーラ	Jírová	イーロヴァー
Jiráček	イラーチェク	Jiráčková	イラーチュコヴァー
Jirák	イラーク	Jiráková	イラーコヴァー
Jiránek	イラーネク	Jiránková	イラーンコヴァー
Jirásek	イラーセク	Jirásková	イラースコヴァー
Jireš	イレシュ	Jirešová	イレショヴァー
Jiříček	イジーチェク	Jiříčková	イジーチュコヴァー
Jiřička	イジチュカ	Jiřičková	イジチュコヴァー
Jiřík	イジーク	Jiříková	イジーコヴァー
Jirka	イルカ	Jirková	イルコヴァー
Jirkovský	イルコフスキー	Jirkovská	イルコフスカー
Jirků	イルクー	Jirků	イルクー
Jirouš	イロウシュ	Jiroušová	イロウショヴァー
Jiroušek	イロウシェク	Jiroušková	イロウシュコヴァー
Jirout	イロウト	Jiroutová	イロウトヴァー
Jírovec	イーロヴェツ	Jírovcová	イーロヴツォヴァー
Jirsa	イルサ	Jirsová	イルソヴァー
Jíša	イーシャ	Jíšová	イーショヴァー
Jonák	ヨナーク	Jonáková	ヨナーコヴァー
Jonáš	ヨナーシュ	Jonášová	ヨナーショヴァー
Jordán	ヨルダーン	Jordánová	ヨルダーノヴァー
Jukl	ユクル	Juklová	ユクロヴァー
Junek	ユネク	Junková	ユンコヴァー
Juračka	ユラチュカ	Juračková	ユラチュコヴァー
Jurák	ユラーク	Juráková	ユラーコヴァー
Juráň	ユラーン	Juráňová	ユラーニョヴァー
Juránek	ユラーネク	Juránková	ユラーンコヴァー
Jurásek	ユラーセク	Jurásková	ユラースコヴァー
Jurášek	ユラーシェク	Jurášková	ユラーシュコヴァー
Jurča	ユルチャ	Jurčová	ユルチョヴァー
Jurčík	ユルチーク	Jurčíková	ユルチーコヴァー
Jureček	ユレチェク	Jurečková	ユレチュコヴァー
Jurečka	ユレチュカ	Jurečková	ユレチュコヴァー
Jurek	ユレク	Jurková	ユルコヴァー
Juřena	ユジェナ	Juřenová	ユジェノヴァー
Juřica	ユジツァ	Juřicová	ユジツォヴァー
Juříček	ユジーチェク	Juříčková	ユジーチュコヴァー
Juřička	ユジチュカ	Juřičková	ユジチュコヴァー
Juřík	ユジーク	Juříková	ユジーコヴァー
Jurka	ユルカ	Jurková	ユルコヴァー
Jůza	ユーザ	Jůzová	ユーゾヴァー
Kabát	カバート	Kabátová	カバートヴァー
Kabeláč	カベラーチュ	Kabeláčová	カベラーチョヴァー
Kabelka	カベルカ	Kabelková	カベルコヴァー
Kábrt	カーブルト	Kábrtová	カーブルトヴァー
Kačer	カチェル	Kačerová	カチェロヴァー
Kachlík	カフリーク	Kachlíková	カフリーコヴァー
Kačírek	カチーレク	Kačírková	カチールコヴァー
Kadavý	カダヴィー	Kadavá	カダヴァー
Kadeřábek	カデジャーベク	Kadeřábková	カデジャープコヴァー
Kadlčákov	カドルチャーコフ	Kadlčákovová	カドルチャーコヴォヴァー
Kadlček	カドルチェク	Kadlčková	カドルチュコヴァー
Kadlčík	カドルチーク	Kadlčíková	カドルチーコヴァー
Kadlec	カドレツ	Kadlecová	カドレツォヴァー
Kadleček	カドレチェク	Kadlečková	カドレチュコヴァー
Kafka	カフカ	Kafková	カフコヴァー
Kahánek	カハーネク	Kahánková	カハーンコヴァー
Kaláb	カラープ	Kalábová	カラーボヴァー
Kalaš	カラシュ	Kalašová	カラショヴァー
Kalčík	カルチーク	Kalčíková	カルチーコヴァー
Kaleja	カレヤ	Kalejová	カレヨヴァー
Kaleta	カレタ	Kaletová	カレトヴァー
Kalina	カリナ	Kalinová	カリノヴァー
Kališ	カリシュ	Kališová	カリショヴァー
Kalivoda	カリヴォダ	Kalivodová	カリヴォドヴァー
Kalous	カロウス	Kalousová	カロウソヴァー
Kalousek	カロウセク	Kalousková	カロウスコヴァー
Kaluža	カルジャ	Kalužová	カルジョヴァー
Kalvoda	カルヴォダ	Kalvodová	カルヴォドヴァー
Kamenický	カメニツキー	Kamenická	カメニツカー
Kameník	カメニーク	Kameníková	カメニーコヴァー
Kamenský	カメンスキー	Kamenská	カメンスカー
Káňa	カーニャ	Káňová	カーニョヴァー
Kaňa	カニャ	Kaňová	カニョヴァー
Kaňák	カニャーク	Kaňáková	カニャーコヴァー
Kaňka	カンカ	Kaňková	カンコヴァー
Kaňkovský	カンコフスキー	Kaňkovská	カンコフスカー
Kaňok	カニョク	Kaňoková	カニョコヴァー
Kapoun	カポウン	Kapounová	カポウノヴァー
Karafiát	カラフィアート	Karafiátová	カラフィアートヴァー
Karas	カラス	Karasová	カラソヴァー
Karásek	カラーセク	Karásková	カラースコヴァー
Karel	カレル	Karelová	カレロヴァー
Kareš	カレシュ	Karešová	カレショヴァー
Karlík	カルリーク	Karlíková	カルリーコヴァー
Kárník	カールニーク	Kárníková	カールニーコヴァー
Karpíšek	カルピーシェク	Karpíšková	カルピーシュコヴァー
Kasal	カサル	Kasalová	カサロヴァー
Kaše	カシェ	Kašová	カショヴァー
Kašík	カシーク	Kašíková	カシーコヴァー
Kasík	カシーク	Kasíková	カシーコヴァー
Kaška	カシュカ	Kašková	カシュコヴァー
Kasl	カスル	Kaslová	カスロヴァー
Kašný	カシュニー	Kašná	カシュナー
Kašpar	カシュパル	Kašparová	カシュパロヴァー
Kašpárek	カシュパーレク	Kašpárková	カシュパールコヴァー
Kaštánek	カシュターネク	Kaštánková	カシュターンコヴァー
Kaucký	カウツキー	Kaucká	カウツカー
Kavka	カフカ	Kavková	カフコヴァー
Kazda	カズダ	Kazdová	カズドヴァー
Kilián	キリアーン	Kiliánová	キリアーノヴァー
Kincl	キンツル	Kinclová	キンツロヴァー
Klapka	クラプカ	Klapková	クラプコヴァー
Klásek	クラーセク	Klásková	クラースコヴァー
Klečka	クレチュカ	Klečková	クレチュコヴァー
Klíč	クリーチュ	Klíčová	クリーチョヴァー
Klička	クリチュカ	Kličková	クリチュコヴァー
Klika	クリカ	Kliková	クリコヴァー
Klíma	クリーマ	Klímová	クリーモヴァー
Klimek	クリメク	Klimková	クリムコヴァー
Klímek	クリーメク	Klímková	クリームコヴァー
Klimeš	クリメシュ	Klimešová	クリメショヴァー
Klimša	クリムシャ	Klimšová	クリムショヴァー
Klofáč	クロファーチュ	Klofáčová	クロファーチョヴァー
Klouček	クロウチェク	Kloučková	クロウチュコヴァー
Klouda	クロウダ	Kloudová	クロウドヴァー
Klusáček	クルサーチェク	Klusáčková	クルサーチュコヴァー
Klusák	クルサーク	Klusáková	クルサーコヴァー
Kment	クメント	Kmentová	クメントヴァー
Kmoníček	クモニーチェク	Kmoníčková	クモニーチュコヴァー
Knápek	クナーペク	Knápková	クナープコヴァー
Knížek	クニージェク	Knížková	クニーシュコヴァー
Knotek	クノテク	Knotková	クノトコヴァー
Kobliha	コブリハ	Koblihová	コブリホヴァー
Koblížek	コブリージェク	Koblížková	コブリーシュコヴァー
Kobylka	コビルカ	Kobylková	コビルコヴァー
Kočí	コチー	Kočí	コチー
Kocián	コツィアーン	Kociánová	コツィアーノヴァー
Kočka	コチュカ	Kočková	コチュコヴァー
Kocourek	コツォウレク	Kocourková	コツォウルコヴァー
Kočvara	コチュヴァラ	Kočvarová	コチュヴァロヴァー
Kofroň	コフロン	Kofroňová	コフロニョヴァー
Kohoutek	コホウテク	Kohoutková	コホウトコヴァー
Kokeš	コケシュ	Kokešová	コケショヴァー
Kokoška	ココシュカ	Kokošková	ココシュコヴァー
Koky	コキ	Kokyová	コキオヴァー
Koláček	コラーチェク	Koláčková	コラーチュコヴァー
Koláčný	コラーチュニー	Koláčná	コラーチュナー
Kolaja	コラヤ	Kolajová	コラヨヴァー
Kolář	コラーシュ	Kolářová	コラージョヴァー
Kolařík	コラジーク	Kolaříková	コラジーコヴァー
Kolda	コルダ	Koldová	コルドヴァー
Kolek	コレク	Kolková	コルコヴァー
Kolínek	コリーネク	Kolínková	コリーンコヴァー
Kolínský	コリーンスキー	Kolínská	コリーンスカー
Kolomazník	コロマズニーク	Kolomazníková	コロマズニーコヴァー
Komárek	コマーレク	Komárková	コマールコヴァー
Komenda	コメンダ	Komendová	コメンドヴァー
Komenský	コメンスキー	Komenská	コメンスカー
Komínek	コミーネク	Komínková	コミーンコヴァー
Komzák	コムザーク	Komzáková	コムザーコヴァー
Koňařík	コニャジーク	Koňaříková	コニャジーコヴァー
Konečný	コネチュニー	Konečná	コネチュナー
Koníček	コニーチェク	Koníčková	コニーチュコヴァー
Konopásek	コノパーセク	Konopásková	コノパースコヴァー
Konvalinka	コンヴァリンカ	Konvalinková	コンヴァリンコヴァー
Konvička	コンヴィチュカ	Konvičková	コンヴィチュコヴァー
Konvičný	コンヴィチュニー	Konvičná	コンヴィチュナー
Kopáček	コパーチェク	Kopáčková	コパーチュコヴァー
Kopačka	コパチュカ	Kopačková	コパチュコヴァー
Kopal	コパル	Kopalová	コパロヴァー
Kopeček	コペチェク	Kopečková	コペチュコヴァー
Kopecký	コペツキー	Kopecká	コペツカー
Kopečný	コペチュニー	Kopečná	コペチュナー
Kopřiva	コプシヴァ	Kopřivová	コプシヴォヴァー
Kořán	コジャーン	Kořánová	コジャーノヴァー
Koranda	コランダ	Korandová	コランドヴァー
Korčák	コルチャーク	Korčáková	コルチャーコヴァー
Kordík	コルディーク	Kordíková	コルディーコヴァー
Korec	コレツ	Korcová	コルツォヴァー
Korecký	コレツキー	Korecká	コレツカー
Kořenek	コジェネク	Kořenková	コジェンコヴァー
Kořínek	コジーネク	Kořínková	コジーンコヴァー
Kos	コス	Kosová	コソヴァー
Košař	コシャシュ	Košařová	コシャジョヴァー
Kosař	コサシュ	Kosařová	コサジョヴァー
Košek	コシェク	Košková	コシュコヴァー
Kosek	コセク	Kosková	コスコヴァー
Kosík	コシーク	Kosíková	コシーコヴァー
Kosina	コシナ	Kosinová	コシノヴァー
Košťál	コシュチャール	Košťálová	コシュチャーロヴァー
Kostelecký	コステレツキー	Kostelecká	コステレツカー
Kostelník	コステルニーク	Kostelníková	コステルニーコヴァー
Kostka	コストカ	Kostková	コストコヴァー
Kotas	コタス	Kotasová	コタソヴァー
Kotásek	コターセク	Kotásková	コタースコヴァー
Kotek	コテク	Kotková	コトコヴァー
Kotík	コチーク	Kotíková	コチーコヴァー
Kotlár	コトラール	Kotlárová	コトラーロヴァー
Kotrba	コトルバ	Kotrbová	コトルボヴァー
Kotrč	コトルチュ	Kotrčová	コトルチョヴァー
Kouba	コウバ	Koubová	コウボヴァー
Koubek	コウベク	Koubková	コウプコヴァー
Koucký	コウツキー	Koucká	コウツカー
Koudela	コウデラ	Koudelová	コウデロヴァー
Koudelka	コウデルカ	Koudelková	コウデルコヴァー
Koukal	コウカル	Koukalová	コウカロヴァー
Kouřil	コウジル	Kouřilová	コウジロヴァー
Koutník	コウトニーク	Koutníková	コウトニーコヴァー
Koutný	コウトニー	Koutná	コウトナー
Koutský	コウツキー	Koutská	コウツカー
Kováč	コヴァーチュ	Kováčová	コヴァーチョヴァー
Kováčik	コヴァーチク	Kováčiková	コヴァーチコヴァー
Koval	コヴァル	Kovalová	コヴァロヴァー
Kovalčík	コヴァルチーク	Kovalčíková	コヴァルチーコヴァー
Kovanda	コヴァンダ	Kovandová	コヴァンドヴァー
Kovář	コヴァーシュ	Kovářová	コヴァージョヴァー
Kovářík	コヴァージーク	Kováříková	コヴァージーコヴァー
Kovařík	コヴァジーク	Kovaříková	コヴァジーコヴァー
Kozák	コザーク	Kozáková	コザーコヴァー
Kozel	コゼル	Kozelová	コゼロヴァー
Koželuh	コジェルフ	Koželuhová	コジェルホヴァー
Kožený	コジェニー	Kožená	コジェナー
Kožíšek	コジーシェク	Kožíšková	コジーシュコヴァー
Kozlík	コズリーク	Kozlíková	コズリーコヴァー
Kozubík	コズビーク	Kozubíková	コズビーコヴァー
Kožušník	コズシュニーク	Kožušníková	コズシュニーコヴァー
Kracík	クラツィーク	Kracíková	クラツィーコヴァー
Kráčmar	クラーチュマル	Kráčmarová	クラーチュマロヴァー
Krahulec	クラフレツ	Krahulcová	クラフルツォヴァー
Krajča	クライチャ	Krajčová	クライチョヴァー
Krajčovič	クライチョヴィチュ	Krajčovičová	クライチョヴィチョヴァー
Krajíček	クライーチェク	Krajíčková	クライーチュコヴァー
Krákora	クラーコラ	Krákorová	クラーコロヴァー
Král	クラール	Králová	クラーロヴァー
Králíček	クラーリーチェク	Králíčková	クラーリーチュコヴァー
Králík	クラーリーク	Králíková	クラーリーコヴァー
Kramář	クラマーシュ	Kramářová	クラマージョヴァー
Krása	クラーサ	Krásová	クラーソヴァー
Krásný	クラースニー	Krásná	クラースナー
Krátký	クラートキー	Krátká	クラートカー
Kratochvíl	クラトフヴィール	Kratochvílová	クラトフヴィーロヴァー
Kratochvil	クラトフヴィル	Kratochvilová	クラトフヴィロヴァー
Krbec	クルベツ	Krbcová	クルブツォヴァー
Krč	クルチュ	Krčová	クルチョヴァー
Krčál	クルチャール	Krčálová	クルチャーロヴァー
Krček	クルチェク	Krčková	クルチュコヴァー
Krčma	クルチュマ	Krčmová	クルチュモヴァー
Krčmář	クルチュマーシュ	Krčmářová	クルチュマージョヴァー
Křeček	クシェチェク	Křečková	クシェチュコヴァー
Krejča	クレイチャ	Krejčová	クレイチョヴァー
Krejcar	クレイツァル	Krejcarová	クレイツァロヴァー
Krejčí	クレイチー	Krejčí	クレイチー
Krejčík	クレイチーク	Krejčíková	クレイチーコヴァー
Krejčíř	クレイチーシュ	Krejčířová	クレイチージョヴァー
Krejčiřík	クレイチジーク	Krejčiříková	クレイチジーコヴァー
Krejsa	クレイサ	Krejsová	クレイソヴァー
Krejza	クレイザ	Krejzová	クレイゾヴァー
Křen	クシェン	Křenová	クシェノヴァー
Křenek	クシェネク	Křenková	クシェンコヴァー
Křepelka	クシェペルカ	Křepelková	クシェペルコヴァー
Křesťan	クシェスチャン	Křesťanová	クシェスチャノヴァー
Křička	クシチュカ	Křičková	クシチュコヴァー
Křikava	クシカヴァ	Křikavová	クシカヴォヴァー
Krist	クリスト	Kristová	クリストヴァー
Křístek	クシーステク	Křístková	クシーストコヴァー
Kristek	クリステク	Kristková	クリストコヴァー
Krištof	クリシュトフ	Krištofová	クリシュトフォヴァー
Křivan	クシヴァン	Křivanová	クシヴァノヴァー
Křivánek	クシヴァーネク	Křivánková	クシヴァーンコヴァー
Křivka	クシフカ	Křivková	クシフコヴァー
Křivský	クシフスキー	Křivská	クシフスカー
Kříž	クシーシュ	Křížová	クシージョヴァー
Križ	クリシュ	Križová	クリジョヴァー
Křížek	クシージェク	Křížková	クシーシュコヴァー
Krkoška	クルコシュカ	Krkošková	クルコシュコヴァー
Krobot	クロボト	Krobotová	クロボトヴァー
Kročil	クロチル	Kročilová	クロチロヴァー
Kropáč	クロパーチュ	Kropáčová	クロパーチョヴァー
Kropáček	クロパーチェク	Kropáčková	クロパーチュコヴァー
Kroščen	クロシュチェン	Kroščenová	クロシュチェノヴァー
Kroupa	クロウパ	Kroupová	クロウポヴァー
Kroutil	クロウチル	Kroutilová	クロウチロヴァー
Krpálek	クルパーレク	Krpálková	クルパールコヴァー
Krpec	クルペツ	Krpcová	クルプツォヴァー
Krsek	クルセク	Krsková	クルスコヴァー
Krška	クルシュカ	Kršková	クルシュコヴァー
Kruliš	クルリシュ	Krulišová	クルリショヴァー
Krupa	クルパ	Krupová	クルポヴァー
Krupička	クルピチュカ	Krupičková	クルピチュコヴァー
Krupka	クルプカ	Krupková	クルプコヴァー
Krušina	クルシナ	Krušinová	クルシノヴァー
Krůta	クルータ	Krůtová	クルートヴァー
Kružík	クルジーク	Kružíková	クルジーコヴァー
Kryštof	クリシュトフ	Kryštofová	クリシュトフォヴァー
Kubala	クバラ	Kubalová	クバロヴァー
Kubálek	クバーレク	Kubálková	クバールコヴァー
Kubáň	クバーン	Kubáňová	クバーニョヴァー
Kubánek	クバーネク	Kubánková	クバーンコヴァー
Kubásek	クバーセク	Kubásková	クバースコヴァー
Kubát	クバート	Kubátová	クバートヴァー
Kubec	クベツ	Kubcová	クブツォヴァー
Kubeček	クベチェク	Kubečková	クベチュコヴァー
Kubečka	クベチュカ	Kubečková	クベチュコヴァー
Kubelík	クベリーク	Kubelíková	クベリーコヴァー
Kubelka	クベルカ	Kubelková	クベルコヴァー
Kuběna	クビェナ	Kuběnová	クビェノヴァー
Kubeš	クベシュ	Kubešová	クベショヴァー
Kubica	クビツァ	Kubicová	クビツォヴァー
Kubíček	クビーチェク	Kubíčková	クビーチュコヴァー
Kubík	クビーク	Kubíková	クビーコヴァー
Kubín	クビーン	Kubínová	クビーノヴァー
Kubiš	クビシュ	Kubišová	クビショヴァー
Kubišta	クビシュタ	Kubištová	クビシュトヴァー
Kubů	クブー	Kubů	クブー
Kuča	クチャ	Kučová	クチョヴァー
Kučera	クチェラ	Kučerová	クチェロヴァー
Kuchař	クハシュ	Kuchařová	クハジョヴァー
Kuchařík	クハジーク	Kuchaříková	クハジーコヴァー
Kuchta	クフタ	Kuchtová	クフトヴァー
Kučírek	クチーレク	Kučírková	クチールコヴァー
Kudela	クデラ	Kudelová	クデロヴァー
Kudělka	クジェルカ	Kudělková	クジェルコヴァー
Kudláček	クドラーチェク	Kudláčková	クドラーチュコヴァー
Kudlička	クドリチュカ	Kudličková	クドリチュコヴァー
Kudrna	クドルナ	Kudrnová	クドルノヴァー
Kufa	クファ	Kufová	クフォヴァー
Kukačka	クカチュカ	Kukačková	クカチュコヴァー
Kukla	ククラ	Kuklová	ククロヴァー
Kuklík	ククリーク	Kuklíková	ククリーコヴァー
Kulhánek	クルハーネク	Kulhánková	クルハーンコヴァー
Kulhavý	クルハヴィー	Kulhavá	クルハヴァー
Kulich	クリフ	Kulichová	クリホヴァー
Kulík	クリーク	Kulíková	クリーコヴァー
Kulíšek	クリーシェク	Kulíšková	クリーシュコヴァー
Kuna	クナ	Kunová	クノヴァー
Kundrát	クンドラート	Kundrátová	クンドラートヴァー
Kuneš	クネシュ	Kunešová	クネショヴァー
Kupčík	クプチーク	Kupčíková	クプチーコヴァー
Kupec	クペツ	Kupcová	クプツォヴァー
Kupka	クプカ	Kupková	クプコヴァー
Kurečka	クレチュカ	Kurečková	クレチュコヴァー
Kůrka	クールカ	Kůrková	クールコヴァー
Kurka	クルカ	Kurková	クルコヴァー
Kůs	クース	Kůsová	クーソヴァー
Kusák	クサーク	Kusáková	クサーコヴァー
Kusý	クスィー	Kusá	クサー
Kutil	クチル	Kutilová	クチロヴァー
Kutílek	クチーレク	Kutílková	クチールコヴァー
Kužel	クジェル	Kuželová	クジェロヴァー
Kužela	クジェラ	Kuželová	クジェロヴァー
Kvapil	クヴァピル	Kvapilová	クヴァピロヴァー
Kvasnička	クヴァスニチュカ	Kvasničková	クヴァスニチュコヴァー
Květoň	クヴェトン	Květoňová	クヴェトニョヴァー
Kyncl	キンツル	Kynclová	キンツロヴァー
Kysela	キセラ	Kyselová	キセロヴァー
Kyselý	キセリー	Kyselá	キセラー
Lakatoš	ラカトシュ	Lakatošová	ラカトショヴァー
Lakomý	ラコミー	Lakomá	ラコマー
Lamač	ラマチュ	Lamačová	ラマチョヴァー
Landa	ランダ	Landová	ランドヴァー
Langr	ラングル	Langrová	ラングロヴァー
Láník	ラーニーク	Láníková	ラーニーコヴァー
Lánský	ラーンスキー	Lánská	ラーンスカー
Lapčík	ラプチーク	Lapčíková	ラプチーコヴァー
Lasák	ラサーク	Lasáková	ラサーコヴァー
Láska	ラースカ	Lásková	ラースコヴァー
Laštovička	ラシュトヴィチュカ	Laštovičková	ラシュトヴィチュコヴァー
Laštovka	ラシュトフカ	Laštovková	ラシュトフコヴァー
Laštůvka	ラシュトゥーフカ	Laštůvková	ラシュトゥーフコヴァー
Látal	ラータル	Látalová	ラータロヴァー
Lavička	ラヴィチュカ	Lavičková	ラヴィチュコヴァー
Lazar	ラザル	Lazarová	ラザロヴァー
Láznička	ラーズニチュカ	Lázničková	ラーズニチュコヴァー
Lebeda	レベダ	Lebedová	レベドヴァー
Ledvina	レドヴィナ	Ledvinová	レドヴィノヴァー
Ledvinka	レドヴィンカ	Ledvinková	レドヴィンコヴァー
Lehký	レフキー	Lehká	レフカー
Lejsek	レイセク	Lejsková	レイスコヴァー
Lekeš	レケシュ	Lekešová	レケショヴァー
Lelek	レレク	Lelková	レルコヴァー
Lepka	レプカ	Lepková	レプコヴァー
Lesák	レサーク	Lesáková	レサーコヴァー
Levý	レヴィー	Levá	レヴァー
Lhoták	ルホターク	Lhotáková	ルホターコヴァー
Lhotský	ルホツキー	Lhotská	ルホツカー
Líbal	リーバル	Líbalová	リーバロヴァー
Lindovský	リンドフスキー	Lindovská	リンドフスカー
Linek	リネク	Linková	リンコヴァー
Lipka	リプカ	Lipková	リプコヴァー
Lipovský	リポフスキー	Lipovská	リポフスカー
Lipský	リプスキー	Lipská	リプスカー
Lipták	リプターク	Liptáková	リプターコヴァー
Liška	リシュカ	Lišková	リシュコヴァー
Lisý	リスィー	Lisá	リサー
Lněnička	ルニェニチュカ	Lněničková	ルニェニチュコヴァー
Lošťák	ロシュチャーク	Lošťáková	ロシュチャーコヴァー
Loučka	ロウチュカ	Loučková	ロウチュコヴァー
Louda	ロウダ	Loudová	ロウドヴァー
Loukota	ロウコタ	Loukotová	ロウコトヴァー
Ludvík	ルドヴィーク	Ludvíková	ルドヴィーコヴァー
Lukáč	ルカーチュ	Lukáčová	ルカーチョヴァー
Lukáš	ルカーシュ	Lukášová	ルカーショヴァー
Lukášek	ルカーシェク	Lukášková	ルカーシュコヴァー
Lukeš	ルケシュ	Lukešová	ルケショヴァー
Luňáček	ルニャーチェク	Luňáčková	ルニャーチュコヴァー
Luňák	ルニャーク	Luňáková	ルニャーコヴァー
Lupač	ルパチュ	Lupačová	ルパチョヴァー
Lyčka	リチュカ	Lyčková	リチュコヴァー
Lysák	リサーク	Lysáková	リサーコヴァー
Máca	マーツァ	Mácová	マーツォヴァー
Macák	マツァーク	Macáková	マツァーコヴァー
Mácal	マーツァル	Mácalová	マーツァロヴァー
Maceček	マツェチェク	Macečková	マツェチュコヴァー
Macek	マツェク	Macková	マツコヴァー
Mach	マフ	Machová	マホヴァー
Mácha	マーハ	Máchová	マーホヴァー
Macháč	マハーチュ	Macháčová	マハーチョヴァー
Machač	マハチュ	Machačová	マハチョヴァー
Macháček	マハーチェク	Macháčková	マハーチュコヴァー
Machala	マハラ	Machalová	マハロヴァー
Machálek	マハーレク	Machálková	マハールコヴァー
Machek	マヘク	Machková	マフコヴァー
Machovec	マホヴェツ	Machovcová	マホヴツォヴァー
Machů	マフー	Machů	マフー
Macík	マツィーク	Macíková	マツィーコヴァー
Macků	マツクー	Macků	マツクー
Maděra	マジェラ	Maděrová	マジェロヴァー
Mádr	マードル	Mádrová	マードロヴァー
Mahdal	マフダル	Mahdalová	マフダロヴァー
Makovec	マコヴェツ	Makovcová	マコヴツォヴァー
Makovička	マコヴィチュカ	Makovičková	マコヴィチュコヴァー
Makovský	マコフスキー	Makovská	マコフスカー
Makula	マクラ	Makulová	マクロヴァー
Malát	マラート	Malátová	マラートヴァー
Malec	マレツ	Malcová	マルツォヴァー
Maleček	マレチェク	Malečková	マレチュコヴァー
Málek	マーレク	Málková	マールコヴァー
Malík	マリーク	Malíková	マリーコヴァー
Mališ	マリシュ	Mališová	マリショヴァー
Malý	マリー	Malá	マラー
Maňák	マニャーク	Maňáková	マニャーコヴァー
Maňásek	マニャーセク	Maňásková	マニャースコヴァー
Mandík	マンディーク	Mandíková	マンディーコヴァー
Mandlík	マンドリーク	Mandlíková	マンドリーコヴァー
Mánek	マーネク	Mánková	マーンコヴァー
Mára	マーラ	Márová	マーロヴァー
Mareček	マレチェク	Marečková	マレチュコヴァー
Marek	マレク	Marková	マルコヴァー
Mareš	マレシュ	Marešová	マレショヴァー
Mařík	マジーク	Maříková	マジーコヴァー
Markovič	マルコヴィチュ	Markovičová	マルコヴィチョヴァー
Maroušek	マロウシェク	Maroušková	マロウシュコヴァー
Maršálek	マルシャーレク	Maršálková	マルシャールコヴァー
Maršík	マルシーク	Maršíková	マルシーコヴァー
Martinák	マルチナーク	Martináková	マルチナーコヴァー
Martinec	マルチネツ	Martincová	マルチンツォヴァー
Martinek	マルチネク	Martinková	マルチンコヴァー
Martínek	マルチーネク	Martínková	マルチーンコヴァー
Martiník	マルチニーク	Martiníková	マルチニーコヴァー
Martinovský	マルチノフスキー	Martinovská	マルチノフスカー
Martinů	マルチヌー	Martinů	マルチヌー
Martynek	マルティネク	Martynková	マルティンコヴァー
Maryška	マリシュカ	Maryšková	マリシュコヴァー
Máša	マーシャ	Mášová	マーショヴァー
Masařík	マサジーク	Masaříková	マサジーコヴァー
Mašek	マシェク	Mašková	マシュコヴァー
Mašín	マシーン	Mašínová	マシーノヴァー
Maška	マシュカ	Mašková	マシュコヴァー
Masopust	マソプスト	Masopustová	マソプストヴァー
Maštalíř	マシュタリーシュ	Maštalířová	マシュタリージョヴァー
Mastný	マストニー	Mastná	マストナー
Matěj	マチェイ	Matějová	マチェヨヴァー
Matějček	マチェイチェク	Matějčková	マチェイチュコヴァー
Matějíček	マチェイーチェク	Matějíčková	マチェイーチュコヴァー
Matějka	マチェイカ	Matějková	マチェイコヴァー
Matějovský	マチェヨフスキー	Matějovská	マチェヨフスカー
Matějů	マチェユー	Matějů	マチェユー
Mátl	マートル	Mátlová	マートロヴァー
Matouš	マトウシュ	Matoušová	マトウショヴァー
Matoušek	マトウシェク	Matoušková	マトウシュコヴァー
Matula	マトゥラ	Matulová	マトゥロヴァー
Matura	マトゥラ	Maturová	マトゥロヴァー
Matušek	マトゥシェク	Matušková	マトゥシュコヴァー
Matuška	マトゥシュカ	Matušková	マトゥシュコヴァー
Matyáš	マティアーシュ	Matyášová	マティアーショヴァー
Matys	マティス	Matysová	マティソヴァー
Matýsek	マティーセク	Matýsková	マティースコヴァー
Mazáč	マザーチュ	Mazáčová	マザーチョヴァー
Mazal	マザル	Mazalová	マザロヴァー
Mazanec	マザネツ	Mazancová	マザンツォヴァー
Mazánek	マザーネク	Mazánková	マザーンコヴァー
Mazur	マズル	Mazurová	マズロヴァー
Měchura	メフラ	Měchurová	メフロヴァー
Medek	メデク	Medková	メトコヴァー
Meduna	メドゥナ	Medunová	メドゥノヴァー
Mejzlík	メイズリーク	Mejzlíková	メイズリーコヴァー
Melichar	メリハル	Melicharová	メリハロヴァー
Melka	メルカ	Melková	メルコヴァー
Mencl	メンツル	Menclová	メンツロヴァー
Menšík	メンシーク	Menšíková	メンシーコヴァー
Měrka	メルカ	Měrková	メルコヴァー
Merta	メルタ	Mertová	メルトヴァー
Mertl	メルトル	Mertlová	メルトロヴァー
Metelka	メテルカ	Metelková	メテルコヴァー
Míča	ミーチャ	Míčová	ミーチョヴァー
Míček	ミーチェク	Míčková	ミーチュコヴァー
Michal	ミハル	Michalová	ミハロヴァー
Míchal	ミーハル	Míchalová	ミーハロヴァー
Michalčík	ミハルチーク	Michalčíková	ミハルチーコヴァー
Michalec	ミハレツ	Michalcová	ミハルツォヴァー
Michálek	ミハーレク	Michálková	ミハールコヴァー
Michalík	ミハリーク	Michalíková	ミハリーコヴァー
Michl	ミフル	Michlová	ミフロヴァー
Michna	ミフナ	Michnová	ミフノヴァー
Mička	ミチュカ	Mičková	ミチュコヴァー
Mika	ミカ	Miková	ミコヴァー
Míka	ミーカ	Míková	ミーコヴァー
Mikel	ミケル	Mikelová	ミケロヴァー
Mikeš	ミケシュ	Mikešová	ミケショヴァー
Mikeska	ミケスカ	Mikesková	ミケスコヴァー
Miklík	ミクリーク	Miklíková	ミクリーコヴァー
Miko	ミコ	Miková	ミコヴァー
Mikoláš	ミコラーシュ	Mikolášová	ミコラーショヴァー
Mikolášek	ミコラーシェク	Mikolášková	ミコラーシュコヴァー
Mikšík	ミクシーク	Mikšíková	ミクシーコヴァー
Mikšovský	ミクショフスキー	Mikšovská	ミクショフスカー
Mikula	ミクラ	Mikulová	ミクロヴァー
Mikuláš	ミクラーシュ	Mikulášová	ミクラーショヴァー
Mikulášek	ミクラーシェク	Mikulášková	ミクラーシュコヴァー
Mikulec	ミクレツ	Mikulcová	ミクルツォヴァー
Mikulecký	ミクレツキー	Mikulecká	ミクレツカー
Mikulenka	ミクレンカ	Mikulenková	ミクレンコヴァー
Mikulík	ミクリーク	Mikulíková	ミクリーコヴァー
Mikulka	ミクルカ	Mikulková	ミクルコヴァー
Mikuš	ミクシュ	Mikušová	ミクショヴァー
Milota	ミロタ	Milotová	ミロトヴァー
Minář	ミナーシュ	Minářová	ミナージョヴァー
Minarčík	ミナルチーク	Minarčíková	ミナルチーコヴァー
Minařík	ミナジーク	Minaříková	ミナジーコヴァー
Míšek	ミーシェク	Míšková	ミーシュコヴァー
Miškovský	ミシュコフスキー	Miškovská	ミシュコフスカー
Mitáš	ミターシュ	Mitášová	ミターショヴァー
Mizera	ミゼラ	Mizerová	ミゼロヴァー
Mládek	ムラーデク	Mládková	ムラートコヴァー
Mlčák	ムルチャーク	Mlčáková	ムルチャーコヴァー
Mlejnek	ムレイネク	Mlejnková	ムレインコヴァー
Mlynář	ムリナーシュ	Mlynářová	ムリナージョヴァー
Mlýnek	ムリーネク	Mlýnková	ムリーンコヴァー
Mohyla	モヒラ	Mohylová	モヒロヴァー
Mojžíš	モイジーシュ	Mojžíšová	モイジーショヴァー
Mokroš	モクロシュ	Mokrošová	モクロショヴァー
Mokrý	モクリー	Mokrá	モクラー
Molnár	モルナール	Molnárová	モルナーロヴァー
Moravčík	モラフチーク	Moravčíková	モラフチーコヴァー
Moravec	モラヴェツ	Moravcová	モラヴツォヴァー
Morávek	モラーヴェク	Morávková	モラーフコヴァー
Motyčka	モティチュカ	Motyčková	モティチュコヴァー
Moučka	モウチュカ	Moučková	モウチュコヴァー
Moudrý	モウドリー	Moudrá	モウドラー
Mráček	ムラーチェク	Mráčková	ムラーチュコヴァー
Mraček	ムラチェク	Mračková	ムラチュコヴァー
Mráz	ムラース	Mrázová	ムラーゾヴァー
Mrázek	ムラーゼク	Mrázková	ムラースコヴァー
Mrkva	ムルクヴァ	Mrkvová	ムルクヴォヴァー
Mrkvička	ムルクヴィチュカ	Mrkvičková	ムルクヴィチュコヴァー
Mucha	ムハ	Muchová	ムホヴァー
Mudra	ムドラ	Mudrová	ムドロヴァー
Munzar	ムンザル	Munzarová	ムンザロヴァー
Musil	ムシル	Musilová	ムシロヴァー
Musílek	ムシーレク	Musílková	ムシールコヴァー
Muška	ムシュカ	Mušková	ムシュコヴァー
Mužík	ムジーク	Mužíková	ムジーコヴァー
Mynář	ミナーシュ	Mynářová	ミナージョヴァー
Myšák	ミシャーク	Myšáková	ミシャーコヴァー
Myška	ミシュカ	Myšková	ミシュコヴァー
Myslivec	ミスリヴェツ	Myslivcová	ミスリヴツォヴァー
Mysliveček	ミスリヴェチェク	Myslivečková	ミスリヴェチュコヴァー
Nádvorník	ナードヴォルニーク	Nádvorníková	ナードヴォルニーコヴァー
Nakládal	ナクラーダル	Nakládalová	ナクラーダロヴァー
Nápravník	ナープラヴニーク	Nápravníková	ナープラヴニーコヴァー
Návrat	ナーヴラト	Návratová	ナーヴラトヴァー
Navrátil	ナヴラーチル	Navrátilová	ナヴラーチロヴァー
Nebeský	ネベスキー	Nebeská	ネベスカー
Nečas	ネチャス	Nečasová	ネチャソヴァー
Nechanický	ネハニツキー	Nechanická	ネハニツカー
Nechvátal	ネフヴァータル	Nechvátalová	ネフヴァータロヴァー
Nedbal	ネドバル	Nedbalová	ネドバロヴァー
Neděla	ネジェラ	Nedělová	ネジェロヴァー
Nedoma	ネドマ	Nedomová	ネドモヴァー
Nedvěd	ネドヴェト	Nedvědová	ネドヴェドヴァー
Nekola	ネコラ	Nekolová	ネコロヴァー
Němec	ニェメツ	Němcová	ニェムツォヴァー
Němeček	ニェメチェク	Němečková	ニェメチュコヴァー
Nepraš	ネプラシュ	Neprašová	ネプラショヴァー
Nerad	ネラト	Neradová	ネラドヴァー
Nešpor	ネシュポル	Nešporová	ネシュポロヴァー
Nesvadba	ネスヴァドバ	Nesvadbová	ネスヴァドボヴァー
Netík	ネチーク	Netíková	ネチーコヴァー
Netolický	ネトリツキー	Netolická	ネトリツカー
Netušil	ネトゥシル	Netušilová	ネトゥシロヴァー
Neužil	ネウジル	Neužilová	ネウジロヴァー
Nezbeda	ネズベダ	Nezbedová	ネズベドヴァー
Nezval	ネズヴァル	Nezvalová	ネズヴァロヴァー
Nikl	ニクル	Niklová	ニクロヴァー
Nohejl	ノヘイル	Nohejlová	ノヘイロヴァー
Nosek	ノセク	Nosková	ノスコヴァー
Nováček	ノヴァーチェク	Nováčková	ノヴァーチュコヴァー
Novaček	ノヴァチェク	Novačková	ノヴァチュコヴァー
Novák	ノヴァーク	Nováková	ノヴァーコヴァー
Novosád	ノヴォサート	Novosádová	ノヴォサードヴァー
Novotný	ノヴォトニー	Novotná	ノヴォトナー
Nový	ノヴィー	Nová	ノヴァー
Nožička	ノジチュカ	Nožičková	ノジチュコヴァー
Nykl	ニクル	Nyklová	ニクロヴァー
Nývlt	ニーヴルト	Nývltová	ニーヴルトヴァー
Obdržálek	オブドルジャーレク	Obdržálková	オブドルジャールコヴァー
Obrovský	オブロフスキー	Obrovská	オブロフスカー
Očenášek	オチェナーシェク	Očenášková	オチェナーシュコヴァー
Odložil	オドロジル	Odložilová	オドロジロヴァー
Odstrčil	オツトルチル	Odstrčilová	オツトルチロヴァー
Odvárka	オドヴァールカ	Odvárková	オドヴァールコヴァー
Oláh	オラーフ	Oláhová	オラーホヴァー
Olejník	オレイニーク	Olejníková	オレイニーコヴァー
Olšák	オルシャーク	Olšáková	オルシャーコヴァー
Onderka	オンデルカ	Onderková	オンデルコヴァー
Ondra	オンドラ	Ondrová	オンドロヴァー
Ondráček	オンドラーチェク	Ondráčková	オンドラーチュコヴァー
Ondrák	オンドラーク	Ondráková	オンドラーコヴァー
Ondrášek	オンドラーシェク	Ondrášková	オンドラーシュコヴァー
Ondříček	オンドジーチェク	Ondříčková	オンドジーチュコヴァー
Ondroušek	オンドロウシェク	Ondroušková	オンドロウシュコヴァー
Ondruch	オンドルフ	Ondruchová	オンドルホヴァー
Ondruš	オンドルシュ	Ondrušová	オンドルショヴァー
Opatrný	オパトルニー	Opatrná	オパトルナー
Opletal	オプレタル	Opletalová	オプレタロヴァー
Opluštil	オプルシュチル	Opluštilová	オプルシュチロヴァー
Opočenský	オポチェンスキー	Opočenská	オポチェンスカー
Oravec	オラヴェツ	Oravcová	オラヴツォヴァー
Orel	オレル	Orelová	オレロヴァー
Orság	オルサーク	Orságová	オルサーゴヴァー
Osička	オシチュカ	Osičková	オシチュコヴァー
Ošťádal	オシュチャーダル	Ošťádalová	オシュチャーダロヴァー
Ostrčil	オストルチル	Ostrčilová	オストルチロヴァー
Otáhal	オターハル	Otáhalová	オターハロヴァー
Pacák	パツァーク	Pacáková	パツァーコヴァー
Pačes	パチェス	Pačesová	パチェソヴァー
Pagáč	パガーチュ	Pagáčová	パガーチョヴァー
Pajer	パイエル	Pajerová	パイエロヴァー
Palacký	パラツキー	Palacká	パラツカー
Palán	パラーン	Palánová	パラーノヴァー
Palát	パラート	Palátová	パラートヴァー
Paleček	パレチェク	Palečková	パレチュコヴァー
Páleníček	パーレニーチェク	Páleníčková	パーレニーチュコヴァー
Páleník	パーレニーク	Páleníková	パーレニーコヴァー
Palička	パリチュカ	Paličková	パリチュコヴァー
Pálka	パールカ	Pálková	パールコヴァー
Panáček	パナーチェク	Panáčková	パナーチュコヴァー
Pánek	パーネク	Pánková	パーンコヴァー
Papež	パペシュ	Papežová	パペジョヴァー
Papoušek	パポウシェク	Papoušková	パポウシュコヴァー
Páral	パーラル	Páralová	パーラロヴァー
Pařík	パジーク	Paříková	パジーコヴァー
Pařízek	パジーゼク	Pařízková	パジースコヴァー
Paroubek	パロウベク	Paroubková	パロウプコヴァー
Pašek	パシェク	Pašková	パシュコヴァー
Paseka	パセカ	Paseková	パセコヴァー
Pastorek	パストレク	Pastorková	パストルコヴァー
Pastrňák	パストルニャーク	Pastrňáková	パストルニャーコヴァー
Pastyřík	パスティジーク	Pastyříková	パスティジーコヴァー
Paták	パターク	Patáková	パターコヴァー
Pátek	パーテク	Pátková	パートコヴァー
Patka	パトカ	Patková	パトコヴァー
Patočka	パトチュカ	Patočková	パトチュコヴァー
Paulík	パウリーク	Paulíková	パウリーコヴァー
Pávek	パーヴェク	Pávková	パーフコヴァー
Pavel	パヴェル	Pavelová	パヴェロヴァー
Pavelec	パヴェレツ	Pavelcová	パヴェルツォヴァー
Pavelek	パヴェレク	Pavelková	パヴェルコヴァー
Pavelka	パヴェルカ	Pavelková	パヴェルコヴァー
Pavlas	パヴラス	Pavlasová	パヴラソヴァー
Pavlásek	パヴラーセク	Pavlásková	パヴラースコヴァー
Pavlát	パヴラート	Pavlátová	パヴラートヴァー
Pavlica	パヴリツァ	Pavlicová	パヴリツォヴァー
Pavlíček	パヴリーチェク	Pavlíčková	パヴリーチュコヴァー
Pavlík	パヴリーク	Pavlíková	パヴリーコヴァー
Pavliš	パヴリシュ	Pavlišová	パヴリショヴァー
Pavlovič	パヴロヴィチュ	Pavlovičová	パヴロヴィチョヴァー
Pavlovský	パヴロフスキー	Pavlovská	パヴロフスカー
Pavlů	パヴルー	Pavlů	パヴルー
Pazderka	パズデルカ	Pazderková	パズデルコヴァー
Pazourek	パゾウレク	Pazourková	パゾウルコヴァー
Pažout	パジョウト	Pažoutová	パジョウトヴァー
Pečenka	ペチェンカ	Pečenková	ペチェンコヴァー
Pecha	ペハ	Pechová	ペホヴァー
Pecháček	ペハーチェク	Pecháčková	ペハーチュコヴァー
Pecina	ペツィナ	Pecinová	ペツィノヴァー
Pečinka	ペチンカ	Pečinková	ペチンコヴァー
Pecka	ペツカ	Pecková	ペツコヴァー
Pejša	ペイシャ	Pejšová	ペイショヴァー
Pekař	ペカシュ	Pekařová	ペカジョヴァー
Pekárek	ペカーレク	Pekárková	ペカールコヴァー
Pěkný	ピェクニー	Pěkná	ピェクナー
Pelán	ペラーン	Pelánová	ペラーノヴァー
Pelc	ペルツ	Pelcová	ペルツォヴァー
Pelikán	ペリカーン	Pelikánová	ペリカーノヴァー
Pelíšek	ペリーシェク	Pelíšková	ペリーシュコヴァー
Peňáz	ペニャース	Peňázová	ペニャーゾヴァー
Pěnička	ピェニチュカ	Pěničková	ピェニチュコヴァー
Pěnkava	ピェンカヴァ	Pěnkavová	ピェンカヴォヴァー
Peřina	ペジナ	Peřinová	ペジノヴァー
Pernica	ペルニツァ	Pernicová	ペルニツォヴァー
Peroutka	ペロウトカ	Peroutková	ペロウトコヴァー
Pešák	ペシャーク	Pešáková	ペシャーコヴァー
Pešek	ペシェク	Pešková	ペシュコヴァー
Peška	ペシュカ	Pešková	ペシュコヴァー
Pešl	ペシュル	Pešlová	ペシュロヴァー
Pešta	ペシュタ	Peštová	ペシュトヴァー
Peták	ペターク	Petáková	ペターコヴァー
Petera	ペテラ	Peterová	ペテロヴァー
Peterek	ペテレク	Peterková	ペテルコヴァー
Peterka	ペテルカ	Peterková	ペテルコヴァー
Petr	ペトル	Petrová	ペトロヴァー
Petráček	ペトラーチェク	Petráčková	ペトラーチュコヴァー
Petrák	ペトラーク	Petráková	ペトラーコヴァー
Petráň	ペトラーン	Petráňová	ペトラーニョヴァー
Petráš	ペトラーシュ	Petrášová	ペトラーショヴァー
Petrásek	ペトラーセク	Petrásková	ペトラースコヴァー
Petrášek	ペトラーシェク	Petrášková	ペトラーシュコヴァー
Petřek	ペッチェク	Petřková	ペッチュコヴァー
Petříček	ペッチーチェク	Petříčková	ペッチーチュコヴァー
Petřík	ペッチーク	Petříková	ペッチーコヴァー
Petrlík	ペトルリーク	Petrlíková	ペトルリーコヴァー
Petrů	ペトルー	Petrů	ペトルー
Petržela	ペトルジェラ	Petrželová	ペトルジェロヴァー
Petrželka	ペトルジェルカ	Petrželková	ペトルジェルコヴァー
Picek	ピツェク	Picková	ピツコヴァー
Pícha	ピーハ	Píchová	ピーホヴァー
Pilař	ピラシュ	Pilařová	ピラジョヴァー
Pilát	ピラート	Pilátová	ピラートヴァー
Pilný	ピルニー	Pilná	ピルナー
Pinkas	ピンカス	Pinkasová	ピンカソヴァー
Pinkava	ピンカヴァ	Pinkavová	ピンカヴォヴァー
Piňos	ピニョス	Piňosová	ピニョソヴァー
Pírek	ピーレク	Pírková	ピールコヴァー
Píša	ピーシャ	Píšová	ピーショヴァー
Piskač	ピスカチュ	Piskačová	ピスカチョヴァー
Pišna	ピシュナ	Pišnová	ピシュノヴァー
Pištěk	ピシュチェク	Pištěková	ピシュチェコヴァー
Piták	ピターク	Pitáková	ピターコヴァー
Pivoňka	ピヴォンカ	Pivoňková	ピヴォンコヴァー
Plaček	プラチェク	Plačková	プラチュコヴァー
Plachý	プラヒー	Plachá	プラハー
Plánička	プラーニチュカ	Pláničková	プラーニチュコヴァー
Plášek	プラーシェク	Plášková	プラーシュコヴァー
Plašil	プラシル	Plašilová	プラシロヴァー
Plášil	プラーシル	Plášilová	プラーシロヴァー
Plch	プルフ	Plchová	プルホヴァー
Plecháč	プレハーチュ	Plecháčová	プレハーチョヴァー
Plechatý	プレハティー	Plechatá	プレハター
Plecitý	プレツィティー	Plecitá	プレツィター
Pleskač	プレスカチュ	Pleskačová	プレスカチョヴァー
Plesník	プレスニーク	Plesníková	プレスニーコヴァー
Pleva	プレヴァ	Plevová	プレヴォヴァー
Plíhal	プリーハル	Plíhalová	プリーハロヴァー
Plíšek	プリーシェク	Plíšková	プリーシュコヴァー
Plíva	プリーヴァ	Plívová	プリーヴォヴァー
Plšek	プルシェク	Plšková	プルシュコヴァー
Pluhař	プルハシュ	Pluhařová	プルハジョヴァー
Plzák	プルザーク	Plzáková	プルザーコヴァー
Poborský	ポボルスキー	Poborská	ポボルスカー
Pochylý	ポヒリー	Pochylá	ポヒラー
Podaný	ポダニー	Podaná	ポダナー
Podešva	ポデシュヴァ	Podešvová	ポデシュヴォヴァー
Podhorský	ポドホルスキー	Podhorská	ポドホルスカー
Podroužek	ポドロウジェク	Podroužková	ポドロウシュコヴァー
Podzimek	ポドズィメク	Podzimková	ポドズィムコヴァー
Pohanka	ポハンカ	Pohanková	ポハンコヴァー
Pohl	ポフル	Pohlová	ポフロヴァー
Pokorný	ポコルニー	Pokorná	ポコルナー
Poláček	ポラーチェク	Poláčková	ポラーチュコヴァー
Polách	ポラーフ	Poláchová	ポラーホヴァー
Polák	ポラーク	Poláková	ポラーコヴァー
Polanský	ポランスキー	Polanská	ポランスカー
Polášek	ポラーシェク	Polášková	ポラーシュコヴァー
Poledník	ポレドニーク	Poledníková	ポレドニーコヴァー
Polínek	ポリーネク	Polínková	ポリーンコヴァー
Polívka	ポリーフカ	Polívková	ポリーフコヴァー
Pololáník	ポロラーニーク	Pololáníková	ポロラーニーコヴァー
Pompa	ポンパ	Pompová	ポンポヴァー
Popek	ポペク	Popková	ポプコヴァー
Popelka	ポペルカ	Popelková	ポペルコヴァー
Popovič	ポポヴィチュ	Popovičová	ポポヴィチョヴァー
Pořízka	ポジースカ	Pořízková	ポジースコヴァー
Poslušný	ポスルシュニー	Poslušná	ポスルシュナー
Pospíchal	ポスピーハル	Pospíchalová	ポスピーハロヴァー
Pospíšil	ポスピーシル	Pospíšilová	ポスピーシロヴァー
Poštulka	ポシュトゥルカ	Poštulková	ポシュトゥルコヴァー
Potůček	ポトゥーチェク	Potůčková	ポトゥーチュコヴァー
Pouzar	ポウザル	Pouzarová	ポウザロヴァー
Povolný	ポヴォルニー	Povolná	ポヴォルナー
Prachař	プラハシュ	Prachařová	プラハジョヴァー
Prášek	プラーシェク	Prášková	プラーシュコヴァー
Prášil	プラーシル	Prášilová	プラーシロヴァー
Pražák	プラジャーク	Pražáková	プラジャーコヴァー
Pražan	プラジャン	Pražanová	プラジャノヴァー
Prchlík	プルフリーク	Prchlíková	プルフリーコヴァー
Přecechtěl	プシェツェフチェル	Přecechtělová	プシェツェフチェロヴァー
Přibyl	プシビル	Přibylová	プシビロヴァー
Přichystal	プシヒスタル	Přichystalová	プシヒスタロヴァー
Přidal	プシダル	Přidalová	プシダロヴァー
Příhoda	プシーホダ	Příhodová	プシーホドヴァー
Přikryl	プシクリル	Přikrylová	プシクリロヴァー
Princ	プリンツ	Princová	プリンツォヴァー
Procházka	プロハースカ	Procházková	プロハースコヴァー
Prokeš	プロケシュ	Prokešová	プロケショヴァー
Prokopec	プロコペツ	Prokopcová	プロコプツォヴァー
Prokš	プロクシュ	Prokšová	プロクショヴァー
Prokůpek	プロクーペク	Prokůpková	プロクープコヴァー
Prošek	プロシェク	Prošková	プロシュコヴァー
Prouza	プロウザ	Prouzová	プロウゾヴァー
Provazník	プロヴァズニーク	Provazníková	プロヴァズニーコヴァー
Průcha	プルーハ	Průchová	プルーホヴァー
Průša	プルーシャ	Průšová	プルーショヴァー
Pšenička	プシェニチュカ	Pšeničková	プシェニチュコヴァー
Ptáček	プターチェク	Ptáčková	プターチュコヴァー
Ptáčník	プターチュニーク	Ptáčníková	プターチュニーコヴァー
Pták	プターク	Ptáková	プターコヴァー
Pudil	プディル	Pudilová	プディロヴァー
Půlpán	プールパーン	Půlpánová	プールパーノヴァー
Punčochář	プンチョハーシュ	Punčochářová	プンチョハージョヴァー
Pustějovský	プスチェヨフスキー	Pustějovská	プスチェヨフスカー
Pustka	プストカ	Pustková	プストコヴァー
Pýcha	ピーハ	Pýchová	ピーホヴァー
Rác	ラーツ	Rácová	ラーツォヴァー
Racek	ラツェク	Racková	ラツコヴァー
Ráček	ラーチェク	Ráčková	ラーチュコヴァー
Rak	ラク	Raková	ラコヴァー
Rambousek	ランボウセク	Rambousková	ランボウスコヴァー
Raška	ラシュカ	Rašková	ラシュコヴァー
Raszka	ラッスカ	Raszková	ラッスコヴァー
Rataj	ラタイ	Ratajová	ラタヨヴァー
Rathouský	ラドホウスキー	Rathouská	ラドホウスカー
Řeháček	ジェハーチェク	Řeháčková	ジェハーチュコヴァー
Řehák	ジェハーク	Řeháková	ジェハーコヴァー
Řehoř	ジェホシュ	Řehořová	ジェホジョヴァー
Rejcha	レイハ	Rejchová	レイホヴァー
Rejsek	レイセク	Rejsková	レイスコヴァー
Rejzek	レイゼク	Rejzková	レイスコヴァー
Remeš	レメシュ	Remešová	レメショヴァー
Řepa	ジェパ	Řepová	ジェポヴァー
Řepka	ジェプカ	Řepková	ジェプコヴァー
Řeřicha	ジェジハ	Řeřichová	ジェジホヴァー
Řežábek	ジェジャーベク	Řežábková	ジェジャープコヴァー
Řezáč	ジェザーチュ	Řezáčová	ジェザーチョヴァー
Rezek	レゼク	Rezková	レスコヴァー
Řezníček	ジェズニーチェク	Řezníčková	ジェズニーチュコヴァー
Řezník	ジェズニーク	Řezníková	ジェズニーコヴァー
Režný	レジュニー	Režná	レジュナー
Řídký	ジートキー	Řídká	ジートカー
Říha	ジーハ	Říhová	ジーホヴァー
Řihák	ジハーク	Řiháková	ジハーコヴァー
Řípa	ジーパ	Řípová	ジーポヴァー
Roček	ロチェク	Ročková	ロチュコヴァー
Roháč	ロハーチュ	Roháčová	ロハーチョヴァー
Roháček	ロハーチェク	Roháčková	ロハーチュコヴァー
Rohlík	ロフリーク	Rohlíková	ロフリーコヴァー
Rokos	ロコス	Rokosová	ロコソヴァー
Rosecký	ロセツキー	Rosecká	ロセツカー
Roubal	ロウバル	Roubalová	ロウバロヴァー
Roubíček	ロウビーチェク	Roubíčková	ロウビーチュコヴァー
Roučka	ロウチュカ	Roučková	ロウチュコヴァー
Roušar	ロウシャル	Roušarová	ロウシャロヴァー
Rousek	ロウセク	Rousková	ロウスコヴァー
Rožnovský	ロジュノフスキー	Rožnovská	ロジュノフスカー
Rubáš	ルバーシュ	Rubášová	ルバーショヴァー
Rubeš	ルベシュ	Rubešová	ルベショヴァー
Ručka	ルチュカ	Ručková	ルチュコヴァー
Rusek	ルセク	Rusková	ルスコヴァー
Rusňák	ルスニャーク	Rusňáková	ルスニャーコヴァー
Růžek	ルージェク	Růžková	ルーシュコヴァー
Ružička	ルジチュカ	Ružičková	ルジチュコヴァー
Růžička	ルージチュカ	Růžičková	ルージチュコヴァー
Ryba	リバ	Rybová	リボヴァー
Rybák	リバーク	Rybáková	リバーコヴァー
Rybář	リバーシュ	Rybářová	リバージョヴァー
Rybka	リプカ	Rybková	リプコヴァー
Rybníček	リブニーチェク	Rybníčková	リブニーチュコヴァー
Rychlík	リフリーク	Rychlíková	リフリーコヴァー
Rychlý	リフリー	Rychlá	リフラー
Rychtařík	リフタジーク	Rychtaříková	リフタジーコヴァー
Rýdl	リードル	Rýdlová	リードロヴァー
Ryšánek	リシャーネク	Ryšánková	リシャーンコヴァー
Ryšavý	リシャヴィー	Ryšavá	リシャヴァー
Ryška	リシュカ	Ryšková	リシュコヴァー
Rytíř	リチーシュ	Rytířová	リチージョヴァー
Rýznar	リーズナル	Rýznarová	リーズナロヴァー
Šabata	シャバタ	Šabatová	シャバトヴァー
Šabatka	シャバトカ	Šabatková	シャバトコヴァー
Sáblík	サーブリーク	Sáblíková	サーブリーコヴァー
Šácha	シャーハ	Šáchová	シャーホヴァー
Šádek	シャーデク	Šádková	シャートコヴァー
Sadílek	サディーレク	Sadílková	サディールコヴァー
Šafář	シャファーシュ	Šafářová	シャファージョヴァー
Šafařík	シャファジーク	Šafaříková	シャファジーコヴァー
Šafránek	シャフラーネク	Šafránková	シャフラーンコヴァー
Salač	サラチュ	Salačová	サラチョヴァー
Salajka	サライカ	Salajková	サライコヴァー
Salák	サラーク	Saláková	サラーコヴァー
Šálek	シャーレク	Šálková	シャールコヴァー
Šámal	シャーマル	Šámalová	シャーマロヴァー
Samec	サメツ	Samcová	サムツォヴァー
Samek	サメク	Samková	サムコヴァー
Šanda	シャンダ	Šandová	シャンドヴァー
Šandera	シャンデラ	Šanderová	シャンデロヴァー
Šandor	シャンドル	Šandorová	シャンドロヴァー
Šašek	シャシェク	Šašková	シャシュコヴァー
Schejbal	スヘイバル	Schejbalová	スヘイバロヴァー
Schovánek	スホヴァーネク	Schovánková	スホヴァーンコヴァー
Ščuka	シュチュカ	Ščuková	シュチュコヴァー
Šebek	シェベク	Šebková	シェプコヴァー
Šebela	シェベラ	Šebelová	シェベロヴァー
Šebesta	シェベスタ	Šebestová	シェベストヴァー
Šebrle	シェブルレ	Šebrlová	シェブルロヴァー
Šeda	シェダ	Šedová	シェドヴァー
Šedivý	シェディヴィー	Šedivá	シェディヴァー
Sedláček	セドラーチェク	Sedláčková	セドラーチュコヴァー
Sedlák	セドラーク	Sedláková	セドラーコヴァー
Sedlář	セドラーシュ	Sedlářová	セドラージョヴァー
Šedý	シェディー	Šedá	シェダー
Šefčík	シェフチーク	Šefčíková	シェフチーコヴァー
Šefl	シェフル	Šeflová	シェフロヴァー
Sehnal	セフナル	Sehnalová	セフナロヴァー
Sejkora	セイコラ	Sejkorová	セイコロヴァー
Šejna	シェイナ	Šejnová	シェイノヴァー
Sekanina	セカニナ	Sekaninová	セカニノヴァー
Šembera	シェンベラ	Šemberová	シェンベロヴァー
Semerád	セメラート	Semerádová	セメラードヴァー
Semerák	セメラーク	Semeráková	セメラーコヴァー
Semrád	セムラート	Semrádová	セムラードヴァー
Šenk	シェンク	Šenková	シェンコヴァー
Šenkeřík	シェンケジーク	Šenkeříková	シェンケジーコヴァー
Šenkýř	シェンキーシュ	Šenkýřová	シェンキージョヴァー
Šenkyřík	シェンキジーク	Šenkyříková	シェンキジーコヴァー
Šerák	シェラーク	Šeráková	シェラーコヴァー
Šerý	シェリー	Šerá	シェラー
Šesták	シェスターク	Šestáková	シェスターコヴァー
Ševčík	シェフチーク	Ševčíková	シェフチーコヴァー
Severa	セヴェラ	Severová	セヴェロヴァー
Šigut	シグト	Šigutová	シグトヴァー
Šikl	シクル	Šiklová	シクロヴァー
Sikora	シコラ	Sikorová	シコロヴァー
Šikula	シクラ	Šikulová	シクロヴァー
Šilar	シラル	Šilarová	シラロヴァー
Šilhan	シルハン	Šilhanová	シルハノヴァー
Šilhán	シルハーン	Šilhánová	シルハーノヴァー
Šilhánek	シルハーネク	Šilhánková	シルハーンコヴァー
Šilhavý	シルハヴィー	Šilhavá	シルハヴァー
Šíma	シーマ	Šímová	シーモヴァー
Šimáček	シマーチェク	Šimáčková	シマーチュコヴァー
Šimák	シマーク	Šimáková	シマーコヴァー
Šiman	シマン	Šimanová	シマノヴァー
Šimánek	シマーネク	Šimánková	シマーンコヴァー
Šimčík	シムチーク	Šimčíková	シムチーコヴァー
Šimeček	シメチェク	Šimečková	シメチュコヴァー
Šimek	シメク	Šimková	シムコヴァー
Šimíček	シミーチェク	Šimíčková	シミーチュコヴァー
Šimík	シミーク	Šimíková	シミーコヴァー
Šimon	シモン	Šimonová	シモノヴァー
Šimoník	シモニーク	Šimoníková	シモニーコヴァー
Šimůnek	シムーネク	Šimůnková	シムーンコヴァー
Šindelář	シンデラーシュ	Šindelářová	シンデラージョヴァー
Šindelka	シンデルカ	Šindelková	シンデルコヴァー
Šindler	シンドレル	Šindlerová	シンドレロヴァー
Šíp	シープ	Šípová	シーポヴァー
Šípek	シーペク	Šípková	シープコヴァー
Šír	シール	Šírová	シーロヴァー
Šírek	シーレク	Šírková	シールコヴァー
Široký	シロキー	Široká	シロカー
Sirotek	シロテク	Sirotková	シロトコヴァー
Šiška	シシュカ	Šišková	シシュコヴァー
Sivák	シヴァーク	Siváková	シヴァーコヴァー
Šivák	シヴァーク	Šiváková	シヴァーコヴァー
Skácel	スカーツェル	Skácelová	スカーツェロヴァー
Skala	スカラ	Skalová	スカロヴァー
Skála	スカーラ	Skálová	スカーロヴァー
Skalický	スカリツキー	Skalická	スカリツカー
Skalka	スカルカ	Skalková	スカルコヴァー
Skalník	スカルニーク	Skalníková	スカルニーコヴァー
Skalský	スカルスキー	Skalská	スカルスカー
Škarda	シュカルダ	Škardová	シュカルドヴァー
Sklář	スクラーシュ	Sklářová	スクラージョヴァー
Sklenář	スクレナーシュ	Sklenářová	スクレナージョヴァー
Sklenička	スクレニチュカ	Skleničková	スクレニチュコヴァー
Škoda	シュコダ	Škodová	シュコドヴァー
Skokan	スコカン	Skokanová	スコカノヴァー
Škop	シュコプ	Škopová	シュコポヴァー
Skopal	スコパル	Skopalová	スコパロヴァー
Škopek	シュコペク	Škopková	シュコプコヴァー
Skořepa	スコジェパ	Skořepová	スコジェポヴァー
Škorpík	シュコルピーク	Škorpíková	シュコルピーコヴァー
Skotnica	スコトニツァ	Skotnicová	スコトニツォヴァー
Skoumal	スコウマル	Skoumalová	スコウマロヴァー
Skoupý	スコウピー	Skoupá	スコウパー
Škrabal	シュクラバル	Škrabalová	シュクラバロヴァー
Skřivan	スクシヴァン	Skřivanová	スクシヴァノヴァー
Skřivánek	スクシヴァーネク	Skřivánková	スクシヴァーンコヴァー
Škrobánek	シュクロバーネク	Škrobánková	シュクロバーンコヴァー
Škuta	シュクタ	Škutová	シュクトヴァー
Škvor	シュクヴォル	Škvorová	シュクヴォロヴァー
Skýpala	スキーパラ	Skýpalová	スキーパロヴァー
Slabý	スラビー	Slabá	スラバー
Sládeček	スラーデチェク	Sládečková	スラーデチュコヴァー
Sládek	スラーデク	Sládková	スラートコヴァー
Sladký	スラトキー	Sladká	スラトカー
Sláma	スラーマ	Slámová	スラーモヴァー
Slanina	スラニナ	Slaninová	スラニノヴァー
Slánský	スラーンスキー	Slánská	スラーンスカー
Slaný	スラニー	Slaná	スラナー
Šlapák	シュラパーク	Šlapáková	シュラパーコヴァー
Slavíček	スラヴィーチェク	Slavíčková	スラヴィーチュコヴァー
Slavický	スラヴィツキー	Slavická	スラヴィツカー
Slavík	スラヴィーク	Slavíková	スラヴィーコヴァー
Šlechta	シュレフタ	Šlechtová	シュレフトヴァー
Šlégr	シュレーグル	Šlégrová	シュレーグロヴァー
Slepička	スレピチュカ	Slepičková	スレピチュコヴァー
Slezáček	スレザーチェク	Slezáčková	スレザーチュコヴァー
Slezák	スレザーク	Slezáková	スレザーコヴァー
Slíva	スリーヴァ	Slívová	スリーヴォヴァー
Slivka	スリフカ	Slivková	スリフコヴァー
Slouka	スロウカ	Slouková	スロウコヴァー
Slováček	スロヴァーチェク	Slováčková	スロヴァーチュコヴァー
Slovaček	スロヴァチェク	Slovačková	スロヴァチュコヴァー
Slovák	スロヴァーク	Slováková	スロヴァーコヴァー
Sluka	スルカ	Sluková	スルコヴァー
Šmahel	シュマヘル	Šmahelová	シュマヘロヴァー
Šmehlík	シュメフリーク	Šmehlíková	シュメフリーコヴァー
Šmejkal	シュメイカル	Šmejkalová	シュメイカロヴァー
Smejkal	スメイカル	Smejkalová	スメイカロヴァー
Smékal	スメーカル	Smékalová	スメーカロヴァー
Šmerda	シュメルダ	Šmerdová	シュメルドヴァー
Smetáček	スメターチェク	Smetáčková	スメターチュコヴァー
Smetana	スメタナ	Smetanová	スメタノヴァー
Šmíd	シュミート	Šmídová	シュミードヴァー
Šmída	シュミーダ	Šmídová	シュミードヴァー
Šmídek	シュミーデク	Šmídková	シュミートコヴァー
Smíšek	スミーシェク	Smíšková	スミーシュコヴァー
Smola	スモラ	Smolová	スモロヴァー
Smolík	スモリーク	Smolíková	スモリーコヴァー
Šmolík	シュモリーク	Šmolíková	シュモリーコヴァー
Smolka	スモルカ	Smolková	スモルコヴァー
Smrček	スムルチェク	Smrčková	スムルチュコヴァー
Smrčka	スムルチュカ	Smrčková	スムルチュコヴァー
Smrž	スムルシュ	Smržová	スムルジョヴァー
Smutný	スムトニー	Smutná	スムトナー
Šnajdr	シュナイドル	Šnajdrová	シュナイドロヴァー
Snášel	スナーシェル	Snášelová	スナーシェロヴァー
Šnobl	シュノブル	Šnoblová	シュノブロヴァー
Snopek	スノペク	Snopková	スノプコヴァー
Sobek	ソベク	Sobková	ソプコヴァー
Sobota	ソボタ	Sobotová	ソボトヴァー
Sobotka	ソボトカ	Sobotková	ソボトコヴァー
Socha	ソハ	Sochová	ソホヴァー
Sochůrek	ソフーレク	Sochůrková	ソフールコヴァー
Sodomka	ソドムカ	Sodomková	ソドムコヴァー
Sojka	ソイカ	Sojková	ソイコヴァー
Sokol	ソコル	Sokolová	ソコロヴァー
Solař	ソラシュ	Solařová	ソラジョヴァー
Šolc	ショルツ	Šolcová	ショルツォヴァー
Soldán	ソルダーン	Soldánová	ソルダーノヴァー
Šonský	ションスキー	Šonská	ションスカー
Šotola	ショトラ	Šotolová	ショトロヴァー
Souček	ソウチェク	Součková	ソウチュコヴァー
Soukal	ソウカル	Soukalová	ソウカロヴァー
Šoukal	ショウカル	Šoukalová	ショウカロヴァー
Soukup	ソウクプ	Soukupová	ソウクポヴァー
Šourek	ショウレク	Šourková	ショウルコヴァー
Soušek	ソウシェク	Soušková	ソウシュコヴァー
Špaček	シュパチェク	Špačková	シュパチュコヴァー
Spáčil	スパーチル	Spáčilová	スパーチロヴァー
Špalek	シュパレク	Špalková	シュパルコヴァー
Šperl	シュペルル	Šperlová	シュペルロヴァー
Spěvák	スピェヴァーク	Spěváková	スピェヴァーコヴァー
Špičák	シュピチャーク	Špičáková	シュピチャーコヴァー
Špička	シュピチュカ	Špičková	シュピチュコヴァー
Spilka	スピルカ	Spilková	スピルコヴァー
Šplíchal	シュプリーハル	Šplíchalová	シュプリーハロヴァー
Spurný	スプルニー	Spurná	スプルナー
Šrámek	シュラーメク	Šrámková	シュラームコヴァー
Srb	スルプ	Srbová	スルボヴァー
Srba	スルバ	Srbová	スルボヴァー
Srnec	スルネツ	Srncová	スルンツォヴァー
Šrom	シュロム	Šromová	シュロモヴァー
Srp	スルプ	Srpová	スルポヴァー
Šrubař	シュルバシュ	Šrubařová	シュルバジョヴァー
Štancl	シュタンツル	Štanclová	シュタンツロヴァー
Staněk	スタニェク	Staněková	スタニェコヴァー
Staník	スタニーク	Staníková	スタニーコヴァー
Stárek	スターレク	Stárková	スタールコヴァー
Starý	スタリー	Stará	スタラー
Stašek	スタシェク	Stašková	スタシュコヴァー
Šťastný	シュチャストニー	Šťastná	シュチャストナー
Štěch	シュチェフ	Štěchová	シュチェホヴァー
Štefan	シュテファン	Štefanová	シュテファノヴァー
Štefek	シュテフェク	Štefková	シュテフコヴァー
Štefka	シュテフカ	Štefková	シュテフコヴァー
Štefl	シュテフル	Šteflová	シュテフロヴァー
Stehlík	ステフリーク	Stehlíková	ステフリーコヴァー
Stehno	ステフノ	Stehnová	ステフノヴァー
Stejskal	ステイスカル	Stejskalová	ステイスカロヴァー
Steklý	ステクリー	Steklá	ステクラー
Štěpán	シュチェパーン	Štěpánová	シュチェパーノヴァー
Štěpánek	シュチェパーネク	Štěpánková	シュチェパーンコヴァー
Štěpáník	シュチェパーニーク	Štěpáníková	シュチェパーニーコヴァー
Štěpnička	シュチェプニチュカ	Štěpničková	シュチェプニチュコヴァー
Štěrba	シュチェルバ	Štěrbová	シュチェルボヴァー
Štětina	シュチェチナ	Štětinová	シュチェチノヴァー
Štětka	シュチェトカ	Štětková	シュチェトコヴァー
Stibor	スチボル	Stiborová	スチボロヴァー
Stibůrek	スチブーレク	Stibůrková	スチブールコヴァー
Štika	シュチカ	Štiková	シュチコヴァー
Štípek	シュチーペク	Štípková	シュチープコヴァー
Štochl	シュトフル	Štochlová	シュトフロヴァー
Stodola	ストドラ	Stodolová	ストドロヴァー
Stodůlka	ストドゥールカ	Stodůlková	ストドゥールコヴァー
Stojka	ストイカ	Stojková	ストイコヴァー
Stoklasa	ストクラサ	Stoklasová	ストクラソヴァー
Stoklásek	ストクラーセク	Stoklásková	ストクラースコヴァー
Štolba	シュトルバ	Štolbová	シュトルボヴァー
Štorek	シュトレク	Štorková	シュトルコヴァー
Štourač	シュトウラチュ	Štouračová	シュトウラチョヴァー
Šťovíček	シュツォヴィーチェク	Šťovíčková	シュツォヴィーチュコヴァー
Straka	ストラカ	Straková	ストラコヴァー
Strakoš	ストラコシュ	Strakošová	ストラコショヴァー
Stránský	ストラーンスキー	Stránská	ストラーンスカー
Stratil	ストラチル	Stratilová	ストラチロヴァー
Středa	スッチェダ	Středová	スッチェドヴァー
Strejc	ストレイツ	Strejcová	ストレイツォヴァー
Strejček	ストレイチェク	Strejčková	ストレイチュコヴァー
Střelec	スッチェレツ	Střelcová	スッチェルツォヴァー
Stříbrný	スッチーブルニー	Stříbrná	スッチーブルナー
Stříteský	スッチーテスキー	Stříteská	スッチーテスカー
Stříž	スッチーシュ	Střížová	スッチージョヴァー
Strmiska	ストルミスカ	Strmisková	ストルミスコヴァー
Strnad	ストルナト	Strnadová	ストルナドヴァー
Strnadel	ストルナデル	Strnadelová	ストルナデロヴァー
Štrobl	シュトロブル	Štroblová	シュトロブロヴァー
Strouhal	ストロウハル	Strouhalová	ストロウハロヴァー
Štrunc	シュトルンツ	Štruncová	シュトルンツォヴァー
Strýček	ストリーチェク	Strýčková	ストリーチュコヴァー
Stuchlík	ストゥフリーク	Stuchlíková	ストゥフリーコヴァー
Stuchlý	ストゥフリー	Stuchlá	ストゥフラー
Studený	ストゥデニー	Studená	ストゥデナー
Studnička	ストゥドニチュカ	Studničková	ストゥドニチュコヴァー
Stupka	ストゥプカ	Stupková	ストゥプコヴァー
Šturma	シュトゥルマ	Šturmová	シュトゥルモヴァー
Štursa	シュトゥルサ	Štursová	シュトゥルソヴァー
Stýblo	スティーブロ	Stýblová	スティーブロヴァー
Šuba	シュバ	Šubová	シュボヴァー
Šubert	シュベルト	Šubertová	シュベルトヴァー
Šubrt	シュブルト	Šubrtová	シュブルトヴァー
Suchánek	スハーネク	Suchánková	スハーンコヴァー
Sucharda	スハルダ	Suchardová	スハルドヴァー
Suchý	スヒー	Suchá	スハー
Suk	スク	Suková	スコヴァー
Šula	シュラ	Šulová	シュロヴァー
Šulák	シュラーク	Šuláková	シュラーコヴァー
Šulc	シュルツ	Šulcová	シュルツォヴァー
Surý	スリー	Surá	スラー
Šustek	シュステク	Šustková	シュストコヴァー
Sůva	スーヴァ	Sůvová	スーヴォヴァー
Šváb	シュヴァープ	Švábová	シュヴァーボヴァー
Svačina	スヴァチナ	Svačinová	スヴァチノヴァー
Švadlenka	シュヴァドレンカ	Švadlenková	シュヴァドレンコヴァー
Švancara	シュヴァンツァラ	Švancarová	シュヴァンツァロヴァー
Švanda	シュヴァンダ	Švandová	シュヴァンドヴァー
Švarc	シュヴァルツ	Švarcová	シュヴァルツォヴァー
Svárovský	スヴァーロフスキー	Svárovská	スヴァーロフスカー
Svatoň	スヴァトン	Svatoňová	スヴァトニョヴァー
Svatoš	スヴァトシュ	Svatošová	スヴァトショヴァー
Švec	シュヴェツ	Švecová	シュヴェツォヴァー
Švéda	シュヴェーダ	Švédová	シュヴェードヴァー
Švehla	シュヴェフラ	Švehlová	シュヴェフロヴァー
Švejda	シュヴェイダ	Švejdová	シュヴェイドヴァー
Svěrák	スヴェラーク	Svěráková	スヴェラーコヴァー
Švestka	シュヴェストカ	Švestková	シュヴェストコヴァー
Světlík	スヴェトリーク	Světlíková	スヴェトリーコヴァー
Sviták	スヴィターク	Svitáková	スヴィターコヴァー
Svítil	スヴィーチル	Svítilová	スヴィーチロヴァー
Svoboda	スヴォボダ	Svobodová	スヴォボドヴァー
Švorc	シュヴォルツ	Švorcová	シュヴォルツォヴァー
Svozil	スヴォズィル	Svozilová	スヴォズィロヴァー
Švrček	シュヴルチェク	Švrčková	シュヴルチュコヴァー
Sychra	スィフラ	Sychrová	スィフロヴァー
Sýkora	スィーコラ	Sýkorová	スィーコロヴァー
Synek	スィネク	Synková	スィンコヴァー
Syrovátka	スィロヴァートカ	Syrovátková	スィロヴァートコヴァー
Syrový	スィロヴィー	Syrová	スィロヴァー
Sysel	スィセル	Syselová	スィセロヴァー
Táborský	ターボルスキー	Táborská	ターボルスカー
Takáč	タカーチュ	Takáčová	タカーチョヴァー
Tancoš	タンツォシュ	Tancošová	タンツォショヴァー
Teplý	テプリー	Teplá	テプラー
Tesař	テサシュ	Tesařová	テサジョヴァー
Tesárek	テサーレク	Tesárková	テサールコヴァー
Tesařík	テサジーク	Tesaříková	テサジーコヴァー
Ticháček	チハーチェク	Ticháčková	チハーチュコヴァー
Tichý	チヒー	Tichá	チハー
Tkáč	トカーチュ	Tkáčová	トカーチョヴァー
Tlapák	トラパーク	Tlapáková	トラパーコヴァー
Tlustý	トルスティー	Tlustá	トルスター
Tobiáš	トビアーシュ	Tobiášová	トビアーショヴァー
Tobola	トボラ	Tobolová	トボロヴァー
Tokár	トカール	Tokárová	トカーロヴァー
Tolar	トラル	Tolarová	トラロヴァー
Toman	トマン	Tomanová	トマノヴァー
Tomanec	トマネツ	Tomancová	トマンツォヴァー
Tománek	トマーネク	Tománková	トマーンコヴァー
Tomáš	トマーシュ	Tomášová	トマーショヴァー
Tomášek	トマーシェク	Tomášková	トマーシュコヴァー
Tomeček	トメチェク	Tomečková	トメチュコヴァー
Tomek	トメク	Tomková	トムコヴァー
Tomeš	トメシュ	Tomešová	トメショヴァー
Tomíček	トミーチェク	Tomíčková	トミーチュコヴァー
Tomšík	トムシーク	Tomšíková	トムシーコヴァー
Tomšů	トムシュー	Tomšů	トムシュー
Topič	トピチュ	Topičová	トピチョヴァー
Toráč	トラーチュ	Toráčová	トラーチョヴァー
Tošovský	トショフスキー	Tošovská	トショフスカー
Touš	トウシュ	Toušová	トウショヴァー
Toušek	トウシェク	Toušková	トウシュコヴァー
Trávníček	トラーヴニーチェク	Trávníčková	トラーヴニーチュコヴァー
Trčka	トルチュカ	Trčková	トルチュコヴァー
Trejbal	トレイバル	Trejbalová	トレイバロヴァー
Třešňák	チェシュニャーク	Třešňáková	チェシュニャーコヴァー
Tříska	トリースカ	Třísková	チースコヴァー
Trněný	トルニェニー	Trněná	トルニェナー
Trnka	トルンカ	Trnková	トルンコヴァー
Troják	トロヤーク	Trojáková	トロヤーコヴァー
Trojan	トロヤン	Trojanová	トロヤノヴァー
Trubač	トルバチュ	Trubačová	トルバチョヴァー
Truhlář	トルフラーシュ	Truhlářová	トルフラージョヴァー
Tučapský	トゥチャプスキー	Tučapská	トゥチャプスカー
Tuček	トゥチェク	Tučková	トゥチュコヴァー
Tůma	トゥーマ	Tůmová	トゥーモヴァー
Tupý	トゥピー	Tupá	トゥパー
Tureček	トゥレチェク	Turečková	トゥレチュコヴァー
Turek	トゥレク	Turková	トゥルコヴァー
Turnovský	トゥルノフスキー	Turnovská	トゥルノフスカー
Turoň	トゥロン	Turoňová	トゥロニョヴァー
Tvarůžek	トヴァルージェク	Tvarůžková	トヴァルーシュコヴァー
Tvrdík	トヴルディーク	Tvrdíková	トヴルディーコヴァー
Tvrdoň	トヴルドン	Tvrdoňová	トヴルドニョヴァー
Tvrdý	トヴルディー	Tvrdá	トヴルダー
Tvrzník	トヴルズニーク	Tvrzníková	トヴルズニーコヴァー
Uchytil	ウヒチル	Uchytilová	ウヒチロヴァー
Uhlík	ウフリーク	Uhlíková	ウフリーコヴァー
Uhlíř	ウフリーシュ	Uhlířová	ウフリージョヴァー
Urban	ウルバン	Urbanová	ウルバノヴァー
Urbančík	ウルバンチーク	Urbančíková	ウルバンチーコヴァー
Urbanec	ウルバネツ	Urbancová	ウルバンツォヴァー
Urbánek	ウルバーネク	Urbánková	ウルバーンコヴァー
Urbášek	ウルバーシェク	Urbášková	ウルバーシュコヴァー
Vacek	ヴァツェク	Vacková	ヴァツコヴァー
Vach	ヴァフ	Vachová	ヴァホヴァー
Vácha	ヴァーハ	Váchová	ヴァーホヴァー
Váchal	ヴァーハル	Váchalová	ヴァーハロヴァー
Vacík	ヴァツィーク	Vacíková	ヴァツィーコヴァー
Václavek	ヴァーツラヴェク	Václavková	ヴァーツラフコヴァー
Václavík	ヴァーツラヴィーク	Václavíková	ヴァーツラヴィーコヴァー
Vaidiš	ヴァイディシュ	Vaidišová	ヴァイディショヴァー
Vajda	ヴァイダ	Vajdová	ヴァイドヴァー
Vala	ヴァラ	Valová	ヴァロヴァー
Vála	ヴァーラ	Válová	ヴァーロヴァー
Valach	ヴァラフ	Valachová	ヴァラホヴァー
Valášek	ヴァラーシェク	Valášková	ヴァラーシュコヴァー
Valčík	ヴァルチーク	Valčíková	ヴァルチーコヴァー
Válek	ヴァーレク	Válková	ヴァールコヴァー
Valenta	ヴァレンタ	Valentová	ヴァレントヴァー
Valeš	ヴァレシュ	Valešová	ヴァレショヴァー
Valíček	ヴァリーチェク	Valíčková	ヴァリーチュコヴァー
Valík	ヴァリーク	Valíková	ヴァリーコヴァー
Vališ	ヴァリシュ	Vališová	ヴァリショヴァー
Válka	ヴァールカ	Válková	ヴァールコヴァー
Valoušek	ヴァロウシェク	Valoušková	ヴァロウシュコヴァー
Váňa	ヴァーニャ	Váňová	ヴァーニョヴァー
Vančura	ヴァンチュラ	Vančurová	ヴァンチュロヴァー
Vaněček	ヴァニェチェク	Vaněčková	ヴァニェチュコヴァー
Vaněk	ヴァニェク	Vaněková	ヴァニェコヴァー
Vaníček	ヴァニーチェク	Vaníčková	ヴァニーチュコヴァー
Vaník	ヴァニーク	Vaníková	ヴァニーコヴァー
Vaniš	ヴァニシュ	Vanišová	ヴァニショヴァー
Vápeník	ヴァーペニーク	Vápeníková	ヴァーペニーコヴァー
Vařeka	ヴァジェカ	Vařeková	ヴァジェコヴァー
Varmuža	ヴァルムジャ	Varmužová	ヴァルムジョヴァー
Vašák	ヴァシャーク	Vašáková	ヴァシャーコヴァー
Vašek	ヴァシェク	Vašková	ヴァシュコヴァー
Vašíček	ヴァシーチェク	Vašíčková	ヴァシーチュコヴァー
Vašina	ヴァシナ	Vašinová	ヴァシノヴァー
Vaško	ヴァシュコ	Vašková	ヴァシュコヴァー
Vašut	ヴァシュト	Vašutová	ヴァシュトヴァー
Vaverka	ヴァヴェルカ	Vaverková	ヴァヴェルコヴァー
Vávra	ヴァーヴラ	Vávrová	ヴァーヴロヴァー
Vavrečka	ヴァヴレチュカ	Vavrečková	ヴァヴレチュコヴァー
Vavřička	ヴァヴジチュカ	Vavřičková	ヴァヴジチュコヴァー
Vavřík	ヴァヴジーク	Vavříková	ヴァヴジーコヴァー
Vavřina	ヴァヴジナ	Vavřinová	ヴァヴジノヴァー
Vavruša	ヴァヴルシャ	Vavrušová	ヴァヴルショヴァー
Vavruška	ヴァヴルシュカ	Vavrušková	ヴァヴルシュコヴァー
Večeřa	ヴェチェジャ	Večeřová	ヴェチェジョヴァー
Večerek	ヴェチェレク	Večerková	ヴェチェルコヴァー
Večerka	ヴェチェルカ	Večerková	ヴェチェルコヴァー
Vedral	ヴェドラル	Vedralová	ヴェドラロヴァー
Vejvoda	ヴェイヴォダ	Vejvodová	ヴェイヴォドヴァー
Veleba	ヴェレバ	Velebová	ヴェレボヴァー
Velecký	ヴェレツキー	Velecká	ヴェレツカー
Velek	ヴェレク	Velková	ヴェルコヴァー
Velička	ヴェリチュカ	Veličková	ヴェリチュコヴァー
Velíšek	ヴェリーシェク	Velíšková	ヴェリーシュコヴァー
Vencl	ヴェンツル	Venclová	ヴェンツロヴァー
Vepřek	ヴェプシェク	Vepřková	ヴェプシュコヴァー
Vesecký	ヴェセツキー	Vesecká	ヴェセツカー
Veselka	ヴェセルカ	Veselková	ヴェセルコヴァー
Veselský	ヴェセルスキー	Veselská	ヴェセルスカー
Veselý	ヴェセリー	Veselá	ヴェセラー
Větrovec	ヴェトロヴェツ	Větrovcová	ヴェトロヴツォヴァー
Větrovský	ヴェトロフスキー	Větrovská	ヴェトロフスカー
Veverka	ヴェヴェルカ	Veverková	ヴェヴェルコヴァー
Vích	ヴィーフ	Víchová	ヴィーホヴァー
Vícha	ヴィーハ	Víchová	ヴィーホヴァー
Vidlák	ヴィドラーク	Vidláková	ヴィドラーコヴァー
Vik	ヴィク	Viková	ヴィコヴァー
Viktora	ヴィクトラ	Viktorová	ヴィクトロヴァー
Viktorin	ヴィクトリン	Viktorinová	ヴィクトリノヴァー
Vilím	ヴィリーム	Vilímová	ヴィリーモヴァー
Vilímek	ヴィリーメク	Vilímková	ヴィリームコヴァー
Vinklárek	ヴィンクラーレク	Vinklárková	ヴィンクラールコヴァー
Vinš	ヴィンシュ	Vinšová	ヴィンショヴァー
Vintr	ヴィントル	Vintrová	ヴィントロヴァー
Víšek	ヴィーシェク	Víšková	ヴィーシュコヴァー
Vít	ヴィート	Vítová	ヴィートヴァー
Vitásek	ヴィターセク	Vitásková	ヴィタースコヴァー
Vítek	ヴィーテク	Vítková	ヴィートコヴァー
Vitouš	ヴィトウシュ	Vitoušová	ヴィトウショヴァー
Vítovec	ヴィートヴェツ	Vítovcová	ヴィートヴツォヴァー
Vítů	ヴィートゥー	Vítů	ヴィートゥー
Vízek	ヴィーゼク	Vízková	ヴィースコヴァー
Vízner	ヴィーズネル	Víznerová	ヴィーズネロヴァー
Vlach	ヴラフ	Vlachová	ヴラホヴァー
Vláčil	ヴラーチル	Vláčilová	ヴラーチロヴァー
Vladyka	ヴラディカ	Vladyková	ヴラディコヴァー
Vlasák	ヴラサーク	Vlasáková	ヴラサーコヴァー
Vlášek	ヴラーシェク	Vlášková	ヴラーシュコヴァー
Vlček	ヴルチェク	Vlčková	ヴルチュコヴァー
Vlk	ヴルク	Vlková	ヴルコヴァー
Vobořil	ヴォボジル	Vobořilová	ヴォボジロヴァー
Voborník	ヴォボルニーク	Voborníková	ヴォボルニーコヴァー
Vocásek	ヴォツァーセク	Vocásková	ヴォツァースコヴァー
Voda	ヴォダ	Vodová	ヴォドヴァー
Vodák	ヴォダーク	Vodáková	ヴォダーコヴァー
Vodička	ヴォディチュカ	Vodičková	ヴォディチュコヴァー
Vodrážka	ヴォドラーシュカ	Vodrážková	ヴォドラーシュコヴァー
Vojáček	ヴォヤーチェク	Vojáčková	ヴォヤーチュコヴァー
Vojkůvka	ヴォイクーフカ	Vojkůvková	ヴォイクーフコヴァー
Vojta	ヴォイタ	Vojtová	ヴォイトヴァー
Vojtěch	ヴォイチェフ	Vojtěchová	ヴォイチェホヴァー
Vojtek	ヴォイテク	Vojtková	ヴォイトコヴァー
Vojtíšek	ヴォイチーシェク	Vojtíšková	ヴォイチーシュコヴァー
Vokáč	ヴォカーチュ	Vokáčová	ヴォカーチョヴァー
Vokál	ヴォカール	Vokálová	ヴォカーロヴァー
Vokoun	ヴォコウン	Vokounová	ヴォコウノヴァー
Vokurka	ヴォクルカ	Vokurková	ヴォクルコヴァー
Volák	ヴォラーク	Voláková	ヴォラーコヴァー
Voldřich	ヴォルドジフ	Voldřichová	ヴォルドジホヴァー
Volejník	ヴォレイニーク	Volejníková	ヴォレイニーコヴァー
Volek	ヴォレク	Volková	ヴォルコヴァー
Volný	ヴォルニー	Volná	ヴォルナー
Vomáčka	ヴォマーチュカ	Vomáčková	ヴォマーチュコヴァー
Vondra	ヴォンドラ	Vondrová	ヴォンドロヴァー
Vondráček	ヴォンドラーチェク	Vondráčková	ヴォンドラーチュコヴァー
Vondrák	ヴォンドラーク	Vondráková	ヴォンドラーコヴァー
Vondrášek	ヴォンドラーシェク	Vondrášková	ヴォンドラーシュコヴァー
Vondrouš	ヴォンドロウシュ	Vondroušová	ヴォンドロウショヴァー
Vondruška	ヴォンドルシュカ	Vondrušková	ヴォンドルシュコヴァー
Vopat	ヴォパト	Vopatová	ヴォパトヴァー
Voráč	ヴォラーチュ	Voráčová	ヴォラーチョヴァー
Voráček	ヴォラーチェク	Voráčková	ヴォラーチュコヴァー
Vorel	ヴォレル	Vorelová	ヴォレロヴァー
Voříšek	ヴォジーシェク	Voříšková	ヴォジーシュコヴァー
Vorlíček	ヴォルリーチェク	Vorlíčková	ヴォルリーチュコヴァー
Vosáhlo	ヴォサーフロ	Vosáhlová	ヴォサーフロヴァー
Vosátka	ヴォサートカ	Vosátková	ヴォサートコヴァー
Vostrý	ヴォストリー	Vostrá	ヴォストラー
Vosyka	ヴォスィカ	Vosyková	ヴォスィコヴァー
Votava	ヴォタヴァ	Votavová	ヴォタヴォヴァー
Votoček	ヴォトチェク	Votočková	ヴォトチュコヴァー
Votruba	ヴォトルバ	Votrubová	ヴォトルボヴァー
Votýpka	ヴォティープカ	Votýpková	ヴォティープコヴァー
Voženílek	ヴォジェニーレク	Voženílková	ヴォジェニールコヴァー
Vrabec	ヴラベツ	Vrabcová	ヴラブツォヴァー
Vrábel	ヴラーベル	Vrábelová	ヴラーベロヴァー
Vráblík	ヴラーブリーク	Vráblíková	ヴラーブリーコヴァー
Vrána	ヴラーナ	Vránová	ヴラーノヴァー
Vránek	ヴラーネク	Vránková	ヴラーンコヴァー
Vranický	ヴラニツキー	Vranická	ヴラニツカー
Vraný	ヴラニー	Vraná	ヴラナー
Vrátný	ヴラートニー	Vrátná	ヴラートナー
Vrba	ヴルバ	Vrbová	ヴルボヴァー
Vrbický	ヴルビツキー	Vrbická	ヴルビツカー
Vrbka	ヴルプカ	Vrbková	ヴルプコヴァー
Vršecký	ヴルシェツキー	Vršecká	ヴルシェツカー
Vrzal	ヴルザル	Vrzalová	ヴルザロヴァー
Všetečka	フシェテチュカ	Všetečková	フシェテチュコヴァー
Vybíral	ヴィビーラル	Vybíralová	ヴィビーラロヴァー
Výborný	ヴィーボルニー	Výborná	ヴィーボルナー
Vychodil	ヴィホディル	Vychodilová	ヴィホディロヴァー
Vydra	ヴィドラ	Vydrová	ヴィドロヴァー
Vyhlídal	ヴィフリーダル	Vyhlídalová	ヴィフリーダロヴァー
Vyhnálek	ヴィフナーレク	Vyhnálková	ヴィフナールコヴァー
Vyhnánek	ヴィフナーネク	Vyhnánková	ヴィフナーンコヴァー
Vykoukal	ヴィコウカル	Vykoukalová	ヴィコウカロヴァー
Vykydal	ヴィキダル	Vykydalová	ヴィキダロヴァー
Vymazal	ヴィマザル	Vymazalová	ヴィマザロヴァー
Vymětal	ヴィメタル	Vymětalová	ヴィメタロヴァー
Vyroubal	ヴィロウバル	Vyroubalová	ヴィロウバロヴァー
Vyskočil	ヴィスコチル	Vyskočilová	ヴィスコチロヴァー
Vysloužil	ヴィスロウジル	Vysloužilová	ヴィスロウジロヴァー
Vystrčil	ヴィストルチル	Vystrčilová	ヴィストルチロヴァー
Vytlačil	ヴィトラチル	Vytlačilová	ヴィトラチロヴァー
Žabka	ジャプカ	Žabková	ジャプコヴァー
Zabloudil	ザブロウディル	Zabloudilová	ザブロウディロヴァー
Zábojník	ザーボイニーク	Zábojníková	ザーボイニーコヴァー
Zábranský	ザーブランスキー	Zábranská	ザーブランスカー
Žáček	ジャーチェク	Žáčková	ジャーチュコヴァー
Zachoval	ザホヴァル	Zachovalová	ザホヴァロヴァー
Zadražil	ザドラジル	Zadražilová	ザドラジロヴァー
Zahálka	ザハールカ	Zahálková	ザハールコヴァー
Záhora	ザーホラ	Záhorová	ザーホロヴァー
Zahrádka	ザフラートカ	Zahrádková	ザフラートコヴァー
Zahradníček	ザフラドニーチェク	Zahradníčková	ザフラドニーチュコヴァー
Zahradník	ザフラドニーク	Zahradníková	ザフラドニーコヴァー
Zajac	ザヤツ	Zajacová	ザヤツォヴァー
Zajíc	ザイーツ	Zajícová	ザイーツォヴァー
Zajíček	ザイーチェク	Zajíčková	ザイーチュコヴァー
Žák	ジャーク	Žáková	ジャーコヴァー
Zálešák	ザーレシャーク	Zálešáková	ザーレシャーコヴァー
Záleský	ザーレスキー	Záleská	ザーレスカー
Žaloudek	ジャロウデク	Žaloudková	ジャロウトコヴァー
Žalud	ジャルト	Žaludová	ジャルドヴァー
Zamazal	ザマザル	Zamazalová	ザマザロヴァー
Zámečník	ザーメチュニーク	Zámečníková	ザーメチュニーコヴァー
Žampach	ジャンパフ	Žampachová	ジャンパホヴァー
Zaoral	ザオラル	Zaoralová	ザオラロヴァー
Zápotocký	ザーポトツキー	Zápotocká	ザーポトツカー
Žárský	ジャールスキー	Žárská	ジャールスカー
Záruba	ザールバ	Zárubová	ザールボヴァー
Zástěra	ザースチェラ	Zástěrová	ザースチェロヴァー
Zatloukal	ザトロウカル	Zatloukalová	ザトロウカロヴァー
Zátopek	ザートペク（ザトペック）	Zátopková	ザートプコヴァー
Zavadil	ザヴァディル	Zavadilová	ザヴァディロヴァー
Záveský	ザーヴェスキー	Záveská	ザーヴェスカー
Závodný	ザーヴォドニー	Závodná	ザーヴォドナー
Zavřel	ザヴジェル	Zavřelová	ザヴジェロヴァー
Zázvorka	ザーズヴォルカ	Zázvorková	ザーズヴォルコヴァー
Zbořil	ズボジル	Zbořilová	ズボジロヴァー
Zbranek	ズブラネク	Zbranková	ズブランコヴァー
Zdeněk	ズデニェク	Zdeněková	ズデニェコヴァー
Zdráhal	ズドラーハル	Zdráhalová	ズドラーハロヴァー
Zdražil	ズドラジル	Zdražilová	ズドラジロヴァー
Zedek	ゼデク	Zedková	ゼトコヴァー
Zedníček	ゼドニーチェク	Zedníčková	ゼドニーチュコヴァー
Zedník	ゼドニーク	Zedníková	ゼドニーコヴァー
Zelenka	ゼレンカ	Zelenková	ゼレンコヴァー
Zelený	ゼレニー	Zelená	ゼレナー
Železný	ジェレズニー	Železná	ジェレズナー
Zelinka	ゼリンカ	Zelinková	ゼリンコヴァー
Zeman	ゼマン	Zemanová	ゼマノヴァー
Zemánek	ゼマーネク	Zemánková	ゼマーンコヴァー
Zemek	ゼメク	Zemková	ゼムコヴァー
Žemlička	ジェムリチュカ	Žemličková	ジェムリチュコヴァー
Ženatý	ジェナティー	Ženatá	ジェナター
Ženíšek	ジェニーシェク	Ženíšková	ジェニーシュコヴァー
Zezula	ゼズラ	Zezulová	ゼズロヴァー
Zezulka	ゼズルカ	Zezulková	ゼズルコヴァー
Zich	ズィフ	Zichová	ズィホヴァー
Židek	ジデク	Židková	ジトコヴァー
Žídek	ジーデク	Žídková	ジートコヴァー
Zídek	ズィーデク	Zídková	ズィートコヴァー
Žiga	ジガ	Žigová	ジゴヴァー
Zíka	ズィーカ	Zíková	ズィーコヴァー
Zikmund	ズィクムント	Zikmundová	ズィクムンドヴァー
Žilka	ジルカ	Žilková	ジルコヴァー
Zima	ズィマ	Zimová	ズィモヴァー
Zíma	ズィーマ	Zímová	ズィーモヴァー
Zítek	ズィーテク	Zítková	ズィートコヴァー
Zítka	ズィートカ	Zítková	ズィートコヴァー
Žitník	ジトニーク	Žitníková	ジトニーコヴァー
Živný	ジヴニー	Živná	ジヴナー
Žižka	ジシュカ	Žižková	ジシュコヴァー
Zlámal	ズラーマル	Zlámalová	ズラーマロヴァー
Zmeškal	ズメシュカル	Zmeškalová	ズメシュカロヴァー
Znamenáček	ズナメナーチェク	Znamenáčková	ズナメナーチュコヴァー
Zoubek	ゾウベク	Zoubková	ゾウプコヴァー
Zouhar	ゾウハル	Zouharová	ゾウハロヴァー
Žůrek	ズーレク	Žůrková	ズールコヴァー
Žurek	ズレク	Žurková	ズルコヴァー
Zvěřina	ズヴェジナ	Zvěřinová	ズヴェジノヴァー
Zvolánek	ズヴォラーネク	Zvolánková	ズヴォラーンコヴァー
Zvonek	ズヴォネク	Zvonková	ズヴォンコヴァー
Zvoníček	ズヴォニーチェク	Zvoníčková	ズヴォニーチュコヴァー
Zýka	ズィーカ	Zýková	ズィーコヴァー