Абаев
Abayev	アバーエフ	Абаева
Abayeva	アバーエヴァ
Абакаров
Abakarov	アバカロフ	Абакарова
Abakarova	アバカロヴァ
Абалкин
Abalkin	アバルキン	Абалкина
Abalkina	アバルキナ
Абдувалиев
Abduvaliyev	アブドゥヴァリエフ	Абдувалиева
Abduvaliyeva	アブドゥヴァリエヴァ
Абдулатипов
Abdulatipov	アブドゥラチポフ	Абдулатипова
Abdulatipova	アブドゥラチポヴァ
Абдулбасиров
Abdulbasirov	アブドゥルバシロフ	Абдулбасирова
Abdulbasirova	アブドゥルバシロヴァ
Абдыев
Abdyyev	アブディエフ	Абдыева
Abdyyeva	アブディエヴァ
Абельцев
Abeltsev	アベリツェフ	Абельцева
Abeltseva	アベリツェヴァ
Абраменков
Abramenkov	アブラメンコフ	Абраменкова
Abramenkova	アブラメンコヴァ
Абрамов
Abramov	アブラモフ	Абрамова
Abramova	アブラモヴァ
Абрикосов
Abrikosov	アブリコーソフ	Абрикосова
Abrikosova	アブリコーソヴァ
Аброськин
Abroskin	アブロシキン	Аброськина
Abroskina	アブロシキナ
Аввакумов
Avvakumov	アヴァクモフ	Аввакумова
Avvakumova	アヴァクモヴァ
Авдеев
Avdeyev	アヴジェーエフ	Авдеева
Avdeyeva	アヴジェーエヴァ
Авдеенко
Avdeyenko	アヴジェーエンコ	Авдеенко
Avdeyenko	アヴジェーエンコ
Авдюшин
Avdyushin	アヴジュシン	Авдюшина
Avdyushina	アヴジュシナ
Аверин
Averin	アヴェリン	Аверина
Averina	アヴェリナ
Аверчев
Averchev	アヴェルチェフ	Аверчева
Avercheva	アヴェルチェヴァ
Аганбегян
Aganbegyan	アガンベギャン	Аганбегяна
Aganbegyana	アガンベギャナ
Агапов
Agapov	アガーポフ	Агапова
Agapova	アガーポヴァ
Агафонов
Agafonov	アガフォノフ	Агафонова
Agafonova	アガフォノヴァ
Агеенков
Ageyenkov	アゲエンコフ	Агеенкова
Ageyenkova	アゲエンコヴァ
Агутин
Agutin	アグーチン	Агутина
Agutina	アグーチナ
Адамишин
Adamishin	アダミーシン	Адамишина
Adamishina	アダミーシナ
Адамов
Adamov	アダモフ	Адамова
Adamova	アダモヴァ
Адров
Adrov	アドロフ	Адрова
Adrova	アドロヴァ
Ажаев
Azhayev	アジャーエフ	Ажаева
Azhayeva	アジャーエヴァ
Азаров
Azarov	アザーロフ	Азарова
Azarova	アザーロヴァ
Акатов
Akatov	アカトフ	Акатова
Akatova	アカトヴァ
Акбаев
Akbayev	アグバエフ	Акбаева
Akbayeva	アグバエヴァ
Акимов
Akimov	アキモフ	Акимова
Akimova	アキモヴァ
Аксаков
Aksakov	アクサーコフ	Аксакова
Aksakova	アクサーコヴァ
Аксёненко
Aksyonenko	アクショーネンコ	Аксёненко
Aksyonenko	アクショーネンコ
Аксёнов
Aksyonov	アクショーノフ	Аксёнова
Aksyonova	アクショーノヴァ
Акулов
Akulov	アクロフ	Акулова
Akulova	アクロヴァ
Алавердов
Alaverdov	アラヴェルドフ	Алавердова
Alaverdova	アラヴェルドヴァ
Алампиев
Alampiyev	アランピエフ	Алампиева
Alampiyeva	アランピエヴァ
Алгинин
Alginin	アルギニン	Алгинина
Alginina	アルギニナ
Алданов
Aldanov	アルダーノフ	Алданова
Aldanova	アルダーノヴァ
Александров
Aleksandrov	アレクサンドロフ	Александрова
Aleksandrova	アレクサンドロヴァ
Алексашенко
Aleksashenko	アレクサシェンコ	Алексашенко
Aleksashenko	アレクサシェンコ
Алексеев
Alekseyev	アレクセーエフ	Алексеева
Alekseyeva	アレクセーエヴァ
Алёхин
Alyokhin	アリョーヒン	Алёхина
Alyokhina	アリョーヒナ
Алёшин
Alyoshin	アリョーシン	Алёшина
Alyoshina	アリョーシナ
Алмазов
Almazov	アルマゾフ	Алмазова
Almazova	アルマゾヴァ
Алтухов
Altukhov	アルトゥーホフ	Алтухова
Altukhova	アルトゥーホヴァ
Альбицкий
Albitsky	アリビツキー	Альбицкая
Albitskaya	アリビツカヤ
Амосов
Amosov	アモソフ	Амосова
Amosova	アモソヴァ
Ананиев
Ananiyev	アナニエフ	Ананиева
Ananiyeva	アナニエヴァ
Андреев
Andreyev	アンドレーエフ	Андреева
Andreyeva	アンドレーエヴァ
Андропов
Andropov	アンドロポフ	Андропова
Andropova	アンドロポヴァ
Аникиев
Anikiyev	アニキエフ	Аникиева
Anikiyeva	アニキエヴァ
Анисимов
Anisimov	アニシモフ	Анисимова
Anisimova	アニシモヴァ
Анисин
Anisin	アニシン	Анисина
Anisina	アニシナ
Аничкин
Anichkin	アニチキン	Аничкина
Anichkina	アニチキナ
Анишев
Anishev	アニシェフ	Анишева
Anisheva	アニシェヴァ
Анохин
Anokhin	アノーヒン	Анохина
Anokhina	アノーヒナ
Анпилогов
Anpilogov	アンピロゴフ	Анпилогова
Anpilogova	アンピロゴヴァ
Антипов
Antipov	アンチーポフ	Антипова
Antipova	アンチーポヴァ
Антоненко
Antonenko	アントネンコ	Антоненко
Antonenko	アントネンコ
Антонов
Antonov	アントーノフ	Антонова
Antonova	アントーノヴァ
Антропов
Antropov	アントロポフ	Антропова
Antropova	アントロポヴァ
Антуфьев
Antufev	アントゥフィエフ	Антуфьева
Antufeva	アントゥフィエヴァ
Ануфриев
Anufriyev	アヌフリエフ	Ануфриева
Anufriyeva	アヌフリエヴァ
Арбатов
Arbatov	アルバトフ	Арбатова
Arbatova	アルバトヴァ
Арбузов
Arbuzov	アルブゾフ	Арбузова
Arbuzova	アルブゾヴァ
Аргеев
Argeyev	アルゲエーフ	Аргеева
Argeyeva	アルゲエーヴァ
Аренский
Arensky	アレンスキー	Аренская
Arenskaya	アレンスカヤ
Арефьев
Arefev	アレフィエフ	Арефьева
Arefeva	アレフィエヴァ
Аржанников
Arzhannikov	アルジャンニコフ	Аржанникова
Arzhannikova	アルジャンニコヴァ
Аринин
Arinin	アリーニン	Аринина
Arinina	アリーニナ
Арсеньев
Arsenev	アルセーニエフ	Арсеньева
Arseneva	アルセーニエヴァ
Арский
Arsky	アルスキー	Арская
Arskaya	アルスカヤ
Артёмов
Artyomov	アルチョモフ	Артёмова
Artyomova	アルチョモヴァ
Артемьев
Artemev	アルチェミエフ	Артемьева
Artemeva	アルチェミエヴァ
Артюхов
Artyukhov	アルチュホフ	Артюхова
Artyukhova	アルチュホヴァ
Архипов
Arkhipov	アルヒポフ	Архипова
Arkhipova	アルヒポヴァ
Арцыбашев
Artsybashev	アルツィバーシェフ	Арцыбашева
Artsybasheva	アルツィバーシェヴァ
Асаев
Asayev	アサエフ	Асаева
Asayeva	アサエヴァ
Аскалонов
Askalonov	アスカロノフ	Аскалонова
Askalonova	アスカロノヴァ
Аскерханов
Askerkhanov	アスケルハノフ	Аскерханова
Askerkhanova	アスケルハノヴァ
Асламов
Aslamov	アスラモフ	Асламова
Aslamova	アスラモヴァ
Асмолов
Asmolov	アスモロフ	Асмолова
Asmolova	アスモロヴァ
Асочаков
Asochakov	アソチャコフ	Асочакова
Asochakova	アソチャコヴァ
Астапченко
Astapchenko	アスタプチェンコ	Астапченко
Astapchenko	アスタプチェンコ
Астафьев
Astafev	アスタフィエフ	Астафьева
Astafeva	アスタフィエヴァ
Астахов
Astakhov	アスタホフ	Астахова
Astakhova	アスタホヴァ
Асылмуратов
Asylmuratov	アスィルムラートフ	Асылмуратова
Asylmuratova	アスィルムラートヴァ
Аулов
Aulov	アウロフ	Аулова
Aulova	アウロヴァ
Афанасьев
Afanasev	アファナシエフ	Афанасьева
Afanaseva	アファナシエヴァ
Афанасьевский
Afanasevsky	アファナシエフスキー	Афанасьевская
Afanasevskaya	アファナシエフスカヤ
Ахунов
Akhunov	アフーノフ	Ахунова
Akhunova	アフーノヴァ
Аюпов
Ayupov	アユーポフ	Аюпова
Ayupova	アユーポヴァ
Аяцков
Ayatskov	アヤツコフ	Аяцкова
Ayatskova	アヤツコヴァ
Бабель
Babel	バーベリ	Бабель
Babel	バーベリ
Бабенко
Babenko	バベンコ	Бабенко
Babenko	バベンコ
Бабичев
Babichev	バビチェフ	Бабичева
Babicheva	バビチェヴァ
Бабурин
Baburin	バブーリン	Бабурина
Baburina	バブーリナ
Бажов
Bazhov	バジョーフ	Бажова
Bazhova	バジョーヴァ
Базаров
Bazarov	バザロフ	Базарова
Bazarova	バザロヴァ
Бакунин
Bakunin	バクーニン	Бакунина
Bakunina	バクーニナ
Бакушеев
Bakusheyev	バクシェエフ	Бакушеева
Bakusheyeva	バクシェエヴァ
Бакшин
Bakshin	バクシン	Бакшина
Bakshina	バクシナ
Балабин
Balabin	バラービン	Балабина
Balabina	バラービナ
Балакин
Balakin	バラキン	Балакина
Balakina	バラキナ
Балакшин
Balakshin	バラクシン	Балакшина
Balakshina	バラクシナ
Балалаев
Balalayev	バララーエフ	Балалаева
Balalayeva	バララーエヴァ
Баланев
Balanev	バラネフ	Баланева
Balaneva	バラネヴァ
Барабанов
Barabanov	バラバノフ	Барабанова
Barabanova	バラバノヴァ
Баранников
Barannikov	バランニコフ	Баранникова
Barannikova	バランニコヴァ
Баранов
Baranov	バラノフ	Баранова
Baranova	バラノヴァ
Барановский
Baranovsky	バラノフスキー	Барановская
Baranovskaya	バラノフスカヤ
Барбашов
Barbashov	バルバショフ	Барбашова
Barbashova	バルバショヴァ
Барсуков
Barsukov	バルスコフ	Барсукова
Barsukova	バルスコヴァ
Барыкин
Barykin	バルィキン	Барыкина
Barykina	バルィキナ
Барышев
Baryshev	バルィシェフ	Барышева
Barysheva	バルィシェヴァ
Барышников
Baryshnikov	バルィシュニコフ	Барышникова
Baryshnikova	バルィシュニコヴァ
Батагаев
Batagayev	バタガエフ	Батагаева
Batagayeva	バタガエヴァ
Батанов
Batanov	バタノフ	Батанова
Batanova	バタノヴァ
Батурин
Baturin	バトゥーリン	Батурина
Baturina	バトゥーリナ
Батюшкин
Batyushkin	バチュシュキン	Батюшкина
Batyushkina	バチュシュキナ
Бацын
Batsyn	バツィン	Бацына
Batsyna	バツィナ
Бачериков
Bacherikov	バチェリコフ	Бачерикова
Bacherikova	バチェリコヴァ
Башмаков
Bashmakov	バシュマコフ	Башмакова
Bashmakova	バシュマコヴァ
Баюнов
Bayunov	バユノフ	Баюнова
Bayunova	バユノヴァ
Баяндин
Bayandin	バヤンジン	Баяндина
Bayandina	バヤンジナ
Бевзенко
Bevzenko	ベヴゼンコ	Бевзенко
Bevzenko	ベヴゼンコ
Бедарев
Bedarev	ベダレフ、ベーダレフ	Бедарева
Bedareva	ベダレヴァ、ベーダレヴァ
Безбородов
Bezborodov	ベズボロドフ	Безбородова
Bezborodova	ベズボロドヴァ
Безруков
Bezrukov	ベズルコフ	Безрукова
Bezrukova	ベズルコヴァ
Бекетов
Beketov	ベケトフ	Бекетова
Beketova	ベケトヴァ
Беков
Bekov	ベーコフ	Бекова
Bekova	ベーコヴァ
Белашов
Belashov	ベラショフ	Белашова
Belashova	ベラショヴァ
Белевкин
Belevkin	ベレフキン	Белевкина
Belevkina	ベレフキナ
Белов
Belov	ベローフ、ベロフ	Белова
Belova	ベローヴァ、ベロヴァ
Белозеров
Belozerov	ベロゼロフ	Белозерова
Belozerova	ベロゼロヴァ
Белоногов
Belonogov	ベロノゴフ	Белоногова
Belonogova	ベロノゴヴァ
Белоносов
Belonosov	ベロノソフ	Белоносова
Belonosova	ベロノソヴァ
Белорусов
Belorusov	ベロルソフ	Белорусова
Belorusova	ベロルソヴァ
Белоусов
Belousov	ベロウソフ	Белоусова
Belousova	ベロウソヴァ
Белых
Belykh	ベルィフ	Белых
Belykh	ベルィフ
Бельтюков
Beltyukov	ベリチュコフ	Бельтюкова
Beltyukova	ベリチュコヴァ
Беляев
Belyayev	ベリャーエフ	Беляева
Belyayeva	ベリャーエヴァ
Беляков
Belyakov	ベリャコフ	Белякова
Belyakova	ベリャコヴァ
Берденников
Berdennikov	ベルジェンニコフ	Берденникова
Berdennikova	ベルジェンニコヴァ
Бердов
Berdov	ベルドフ	Бердова
Berdova	ベルドヴァ
Березин
Berezin	ベレージン	Березина
Berezina	ベレージナ
Березовский
Berezovsky	ベレゾフスキー	Березовская
Berezovskaya	ベレゾフスカヤ
Береснев
Beresnev	ベレスネフ	Береснева
Beresneva	ベレスネヴァ
Беседин
Besedin	ベセージン	Беседина
Besedina	ベセージナ
Беспалов
Bespalov	ベスパロフ	Беспалова
Bespalova	ベスパロヴァ
Бессарабов
Bessarabov	ベッサラーボフ	Бессарабова
Bessarabova	ベッサラーボヴァ
Бесхмельницын
Beskhmelnitsyn	ベスフメリニツィン	Бесхмельницына
Beskhmelnitsyna	ベスフメリニツィナ
Бетин
Betin	ベーチン	Бетина
Betina	ベーチナ
Бешкарев
Beshkarev	ベシュカレフ	Бешкарева
Beshkareva	ベシュカレヴァ
Биндюков
Bindyukov	ビンジュコフ	Биндюкова
Bindyukova	ビンジュコヴァ
Бирюков
Biryukov	ビリュコフ	Бирюкова
Biryukova	ビリュコヴァ
Благоволин
Blagovolin	ブラゴヴォリン	Благоволина
Blagovolina	ブラゴヴォリナ
Блинников
Blinnikov	ブリンニコフ	Блинникова
Blinnikova	ブリンニコヴァ
Блинов
Blinov	ブリノフ	Блинова
Blinova	ブリノヴァ
Блохин
Blokhin	ブロヒーン	Блохина
Blokhina	ブロヒーナ
Бобков
Bobkov	ボプコフ	Бобкова
Bobkova	ボプコヴァ
Бобров
Bobrov	ボブロフ	Боброва
Bobrova	ボブロヴァ
Бобровский
Bobrovsky	ボブロフスキー	Бобровская
Bobrovskaya	ボブロフスカヤ
Бобылев
Bobylev	ボブィレフ	Бобылева
Bobyleva	ボブィレヴァ
Богатов
Bogatov	ボガトフ	Богатова
Bogatova	ボガトヴァ
Богданов
Bogdanov	ボグダーノフ	Богданова
Bogdanova	ボグダーノヴァ
Богинский
Boginsky	ボギンスキー	Богинская
Boginskaya	ボギンスカヤ
Боголюбский
Bogolyubsky	ボゴリュプスキー	Боголюбская
Bogolyubskaya	ボゴリュプスカヤ
Богомолов
Bogomolov	ボゴモロフ	Богомолова
Bogomolova	ボゴモロヴァ
Бодин
Bodin	ボージン	Бодина
Bodina	ボージナ
Бодров
Bodrov	ボドロフ	Бодрова
Bodrova	ボドロヴァ
Бодрягин
Bodryagin	ボドリャギン	Бодрягина
Bodryagina	ボドリャギナ
Бойцев
Boytsev	ボイツェフ	Бойцева
Boytseva	ボイツェヴァ
Боков
Bokov	ボーコフ	Бокова
Bokova	ボーコヴァ
Боковиков
Bokovikov	ボコヴィコフ	Боковикова
Bokovikova	ボコヴィコヴァ
Болдин
Boldin	ボールジン	Болдина
Boldina	ボールジナ
Болдырев
Boldyrev	ボールドィレフ、ボルドィレフ	Болдырева
Boldyreva	ボールドィレヴァ、ボルドィレヴァ
Болин
Bolin	ボーリン	Болина
Bolina	ボーリナ
Болотов
Bolotov	ボロトフ	Болотова
Bolotova	ボロトヴァ
Большаков
Bolshakov	ボリシャコフ	Большакова
Bolshakova	ボリシャコヴァ
Бондарев
Bondarev	ボーンダレフ、ボンダレフ	Бондарева
Bondareva	ボーンダレヴァ、ボンダレヴァ
Бондаренко
Bondarenko	ボンダレンコ	Бондаренко
Bondarenko	ボンダレンコ
Бордюжа
Bordyuzha	ボルジュジャ	Бордюжа
Bordyuzha	ボルジュジャ
Борисенко
Borisenko	ボリセンコ	Борисенко
Borisenko	ボリセンコ
Борисов
Borisov	ボリソフ	Борисова
Borisova	ボリソヴァ
Бородаев
Borodayev	ボロダエフ	Бородаева
Borodayeva	ボロダエヴァ
Бородин
Borodin	ボロジーン	Бородина
Borodina	ボロジーナ
Бородулин
Borodulin	ボロドゥリン	Бородулина
Borodulina	ボロドゥリナ
Борщёв
Borshchyov	ボルショフ、ボルシチョフ	Борщёва
Borshchyova	ボルショヴァ、ボルシチョヴァ
Босхолов
Boskholov	ボスホロフ	Босхолова
Boskholova	ボスホロヴァ
Бочарников
Bocharnikov	ボチャルニコフ	Бочарникова
Bocharnikova	ボチャルニコヴァ
Бочаров
Bocharov	ボチャロフ	Бочарова
Bocharova	ボチャロヴァ
Бочкарёв
Bochkaryov	ボチカリョフ	Бочкарёва
Bochkaryova	ボチカリョヴァ
Брагин
Bragin	ブラーギン	Брагина
Bragina	ブラーギナ
Брагинский
Braginsky	ブラギンスキー	Брагинская
Braginskaya	ブラギンスカヤ
Братищев
Bratishchev	ブラチーシェフ、ブラチーシチェフ	Братищева
Bratishcheva	ブラチーシェヴァ、ブラチーシチェヴァ
Братухин
Bratukhin	ブラトゥヒン	Братухина
Bratukhina	ブラトゥヒナ
Бруданин
Brudanin	ブルダニン	Бруданина
Brudanina	ブルダニナ
Брусницын
Brusnitsyn	ブルスニツィン	Брусницына
Brusnitsyna	ブルスニツィナ
Брынцалов
Bryntsalov	ブルィンツァロフ	Брынцалова
Bryntsalova	ブルィンツァロヴァ
Брюханов
Bryukhanov	ブリュハノフ	Брюханова
Bryukhanova	ブリュハノヴァ
Бубенин
Bubenin	ブベーニン	Бубенина
Bubenina	ブベーニナ
Бубякин
Bubyakin	ブビャーキン	Бубякина
Bubyakina	ブビャーキナ
Бугаев
Bugayev	ブガエフ	Бугаева
Bugayeva	ブガエヴァ
Бугдаев
Bugdayev	ブグダエフ	Бугдаева
Bugdayeva	ブグダエヴァ
Бугримов
Bugrimov	ブグリモフ	Бугримова
Bugrimova	ブグリモヴァ
Будажапов
Budazhapov	ブダジャポフ	Будажапова
Budazhapova	ブダジャポヴァ
Бузов
Buzov	ブーゾフ	Бузова
Buzova	ブーゾヴァ
Булавинов
Bulavinov	ブラヴィノフ	Булавинова
Bulavinova	ブラヴィノヴァ
Булгаков
Bulgakov	ブルガーコフ	Булгакова
Bulgakova	ブルガーコヴァ
Булдаев
Buldayev	ブルダエフ	Булдаева
Buldayeva	ブルダエヴァ
Булыгин
Bulygin	ブルィギン	Булыгина
Bulygina	ブルィギナ
Бунин
Bunin	ブーニン	Бунина
Bunina	ブーニナ
Буньков
Bunkov	ブニコフ	Бунькова
Bunkova	ブニコヴァ
Бураченко
Burachenko	ブラチェンコ	Бураченко
Burachenko	ブラチェンコ
Бурдуков
Burdukov	ブルドゥコフ	Бурдукова
Burdukova	ブルドゥコヴァ
Бурдуковский
Burdukovsky	ブルドゥコフスキー	Бурдуковская
Burdukovskaya	ブルドゥコフスカヤ
Бурков
Burkov	ブルコフ	Буркова
Burkova	ブルコヴァ
Бурлаков
Burlakov	ブルラコフ	Бурлакова
Burlakova	ブルラコヴァ
Буров
Burov	ブーロフ	Бурова
Burova	ブーロヴァ
Бутенко
Butenko	ブチェンコ	Бутенко
Butenko	ブチェンコ
Буткеев
Butkeyev	ブトケエフ	Буткеева
Butkeyeva	ブトケエヴァ
Бутов
Butov	ブートフ	Бутова
Butova	ブートヴァ
Буторин
Butorin	ブトーリン	Буторина
Butorina	ブトーリナ
Буханцев
Bukhantsev	ブハンツェフ	Буханцева
Bukhantseva	ブハンツェヴァ
Бученков
Buchenkov	ブチェンコフ	Бученкова
Buchenkova	ブチェンコヴァ
Бушмин
Bushmin	ブシュミン	Бушмина
Bushmina	ブシュミナ
Бушуев
Bushuyev	ブシュエフ	Бушуева
Bushuyeva	ブシュエヴァ
Быков
Bykov	ブィコフ	Быкова
Bykova	ブィコヴァ
Быстров
Bystrov	ブィストロフ	Быстрова
Bystrova	ブィストロヴァ
Быстрянцев
Bystryantsev	ブィストリャンツェフ	Быстрянцева
Bystryantseva	ブィストリャンツェヴァ
Бычков
Bychkov	ブィチコフ	Бычкова
Bychkova	ブィチコヴァ
Вавилов
Vavilov	ヴァヴィロフ	Вавилова
Vavilova	ヴァヴィロヴァ
Ваганов
Vaganov	ヴァガノフ、ヴァガーノフ	Ваганова
Vaganova	ヴァガノヴァ、ヴァガーノヴァ（ワガノワ）
Вазиев
Vaziyev	ヴァジエフ	Вазиева
Vaziyeva	ヴァジエヴァ
Вакуленко
Vakulenko	ヴァクレンコ	Вакуленко
Vakulenko	ヴァクレンコ
Вакулин
Vakulin	ヴァクリン	Вакулина
Vakulina	ヴァクリナ
Вакунин
Vakunin	ヴァクーニン	Вакунина
Vakunina	ヴァクーニナ
Валеев
Valeyev	ヴァレーエフ	Валеева
Valeyeva	ヴァレーエヴァ
Валов
Valov	ヴァロフ	Валова
Valova	ヴァロヴァ
Варенников
Varennikov	ヴァレンニコフ	Варенникова
Varennikova	ヴァレンニコヴァ
Варламов
Varlamov	ヴァルラモフ	Варламова
Varlamova	ヴァルラモヴァ
Варнавский
Varnavsky	ヴァルナフスキー	Варнавская
Varnavskaya	ヴァルナフスカヤ
Варов
Varov	ヴァロフ	Варова
Varova	ヴァロヴァ
Варухин
Varukhin	ヴァルーヒン	Варухина
Varukhina	ヴァルーヒナ
Василев
Vasilev	ヴァシレフ	Василева
Vasileva	ヴァシレヴァ
Василевский
Vasilevsky	ヴァシレフスキー	Василевская
Vasilevskaya	ヴァシレフスカヤ
Василишин
Vasilishin	ヴァシリーシン	Василишина
Vasilishina	ヴァシリーシナ
Васильев
Vasilev	ヴァシーリエフ	Васильева
Vasileva	ヴァシーリエヴァ
Васильченко
Vasilchenko	ヴァシリチェンコ	Васильченко
Vasilchenko	ヴァシリチェンコ
Вахруков
Vakhrukov	ヴァフルコフ	Вахрукова
Vakhrukova	ヴァフルコヴァ
Ващенко
Vashchenko	ヴァーシェンコ、ヴァーシチェンコ	Ващенко
Vashchenko	ヴァーシェンコ、ヴァーシチェンコ
Ващенков
Vashchenkov	ヴァーシェンコフ、ヴァーシチェンコフ	Ващенкова
Vashchenkova	ヴァーシェンコヴァ、ヴァーシチェンコヴァ
Ведерников
Vedernikov	ヴェジェルニコフ	Ведерникова
Vedernikova	ヴェジェルニコヴァ
Велихов
Velikhov	ヴェリホフ	Велихова
Velikhova	ヴェリホヴァ
Венгеров
Vengerov	ヴェンゲロフ	Венгерова
Vengerova	ヴェンゲロヴァ
Венгеровский
Vengerovsky	ヴェンゲロフスキー	Венгеровская
Vengerovskaya	ヴェンゲロフスカヤ
Веретенников
Veretennikov	ヴェレチェンニコフ	Веретенникова
Veretennikova	ヴェレチェンニコヴァ
Вершинин
Vershinin	ヴェルシーニン	Вершинина
Vershinina	ヴェルシーニナ
Весёлкин
Vesyolkin	ヴェショールキン	Весёлкина
Vesyolkina	ヴェショールキナ
Веселов
Veselov	ヴェセローフ	Веселова
Veselova	ヴェセローヴァ
Вечеслов
Vecheslov	ヴェチェスロフ	Вечеслова
Vecheslova	ヴェチェスロヴァ
Вечкасов
Vechkasov	ヴェチカソフ	Вечкасова
Vechkasova	ヴェチカソヴァ
Вешняков
Veshnyakov	ヴェシュニャコフ	Вешнякова
Veshnyakova	ヴェシュニャコヴァ
Видьманов
Vidmanov	ヴィジマノフ	Видьманова
Vidmanova	ヴィジマノヴァ
Викулов
Vikulov	ヴィクロフ	Викулова
Vikulova	ヴィクロヴァ
Вильчинский
Vilchinsky	ヴィリチンスキー	Вильчинская
Vilchinskaya	ヴィリチンスカヤ
Виноградов
Vinogradov	ヴィノグラドフ	Виноградова
Vinogradova	ヴィノグラドヴァ
Винокуров
Vinokurov	ヴィノクロフ	Винокурова
Vinokurova	ヴィノクロヴァ
Витебский
Vitebsky	ヴィチェプスキー	Витебская
Vitebskaya	ヴィチェプスカヤ
Вишнёв
Vishnyov	ヴィシュニョーフ	Вишнёва
Vishnyova	ヴィシュニョーヴァ
Вишневский
Vishnevsky	ヴィシュネフスキー	Вишневская
Vishnevskaya	ヴィシュネフスカヤ
Вишняков
Vishnyakov	ヴィシュニャコフ	Вишнякова
Vishnyakova	ヴィシュニャコヴァ
Владимиров
Vladimirov	ヴラジーミロフ	Владимирова
Vladimirova	ヴラジーミロヴァ
Власов
Vlasov	ヴラーソフ	Власова
Vlasova	ヴラーソヴァ
Водорезов
Vodorezov	ヴォドレゾフ	Водорезова
Vodorezova	ヴォドレゾヴァ
Водянов
Vodyanov	ヴォジャノフ	Водянова
Vodyanova	ヴォジャノヴァ
Войкин
Voykin	ヴォイキン	Войкина
Voykina	ヴォイキナ
Войков
Voykov	ヴォイコフ	Войкова
Voykova	ヴォイコヴァ
Войлуков
Voylukov	ヴォイルコフ	Войлукова
Voylukova	ヴォイルコヴァ
Войнов
Voynov	ヴォイノフ	Войнова
Voynova	ヴォイノヴァ
Волгин
Volgin	ヴォールギン	Волгина
Volgina	ヴォールギナ
Волдорин
Voldorin	ヴォルドリン	Волдорина
Voldorina	ヴォルドリナ
Волегов
Volegov	ヴォレゴフ	Волегова
Volegova	ヴォレゴヴァ
Волженцев
Volzhentsev	ヴォルジェンツェフ	Волженцева
Volzhentseva	ヴォルジェンツェヴァ
Волин
Volin	ヴォリン	Волина
Volina	ヴォリナ
Волков
Volkov	ヴォルコフ	Волкова
Volkova	ヴォルコヴァ
Волковский
Volkovsky	ヴォルコフスキー	Волковская
Volkovskaya	ヴォルコフスカヤ
Волкогонов
Volkogonov	ヴォルコゴノフ	Волкогонова
Volkogonova	ヴォルコゴノヴァ
Волобуев
Volobuyev	ヴォロブエフ	Волобуева
Volobuyeva	ヴォロブエヴァ
Володин
Volodin	ヴォロジン	Володина
Volodina	ヴォロジナ
Волох
Volokh	ヴォロフ	Волох
Volokh	ヴォロフ
Волочков
Volochkov	ヴォロチコフ	Волочкова
Volochkova	ヴォロチコヴァ
Волынцев
Volyntsev	ヴォルィンツェフ	Волынцева
Volyntseva	ヴォルィンツェヴァ
Вольский
Volsky	ヴォリスキー	Вольская
Volskaya	ヴォリスカヤ
Воробьев
Vorobev	ヴォロビエフ	Воробьева
Vorobeva	ヴォロビエヴァ
Ворогушин
Vorogushin	ヴォログーシン	Ворогушина
Vorogushina	ヴォログーシナ
Воронин
Voronin	ヴォローニン	Воронина
Voronina	ヴォローニナ
Воронов
Voronov	ヴォロノフ	Воронова
Voronova	ヴォロノヴァ
Воронцов
Vorontsov	ヴォロンツォフ	Воронцова
Vorontsova	ヴォロンツォヴァ
Воропаев
Voropayev	ヴォロパーエフ	Воропаева
Voropayeva	ヴォロパーエヴァ
Воротников
Vorotnikov	ヴォロトニコフ	Воротникова
Vorotnikova	ヴォロトニコヴァ
Ворфоломеев
Vorfolomeyev	ヴォルフォロメエフ	Ворфоломеева
Vorfolomeyeva	ヴォルフォロメエヴァ
Восковетский
Voskovetsky	ヴォスコヴェツキー	Восковетская
Voskovetskaya	ヴォスコヴェツカヤ
Востротин
Vostrotin	ヴォストロチン	Востротина
Vostrotina	ヴォストロチナ
Выборнов
Vybornov	ヴィボルノフ	Выборнова
Vybornova	ヴィボルノヴァ
Вылегжанин
Vylegzhanin	ヴィレグジャーニン	Вылегжанина
Vylegzhanina	ヴィレグジャーニナ
Выучейский
Vyucheysky	ヴィウチェイスキー	Выучейская
Vyucheyskaya	ヴィウチェイスカヤ
Вялков
Vyalkov	ヴャルコフ	Вялкова
Vyalkova	ヴャルコヴァ
Габоев
Gaboyev	ガボエフ	Габоева
Gaboyeva	ガボエヴァ
Гаврилов
Gavrilov	ガヴリーロフ	Гаврилова
Gavrilova	ガヴリーロヴァ
Гагарин
Gagarin	ガガーリン	Гагарина
Gagarina	ガガーリナ
Газеев
Gazeyev	ガゼーエフ	Газеева
Gazeyeva	ガゼーエヴァ
Гайдуков
Gaydukov	ガイドゥコフ	Гайдукова
Gaydukova	ガイドゥコヴァ
Галавтеев
Galavteyev	ガラフチェエフ	Галавтеева
Galavteyeva	ガラフチェエヴァ
Галанов
Galanov	ガラノフ	Галанова
Galanova	ガラノヴァ
Галин
Galin	ガーリン	Галина
Galina	ガーリナ
Галкин
Galkin	ガールキン	Галкина
Galkina	ガールキナ
Гальченко
Galchenko	ガリチェンコ	Гальченко
Galchenko	ガリチェンコ
Гамидов
Gamidov	ガミドフ	Гамидова
Gamidova	ガミドヴァ
Ганибалов
Ganibalov	ガニバロフ	Ганибалова
Ganibalova	ガニバロヴァ
Гапеев
Gapeyev	ガペーエフ	Гапеева
Gapeyeva	ガペーエヴァ
Гармашов
Garmashov	ガルマショフ	Гармашова
Garmashova	ガルマショヴァ
Гаршин
Garshin	ガールシン	Гаршина
Garshina	ガールシナ
Гачинский
Gachinsky	ガチンスキー	Гачинская
Gachinskaya	ガチンスカヤ
Гаюльский
Gayulsky	ガユリスキー	Гаюльская
Gayulskaya	ガユリスカヤ
Гвоздарёв
Gvozdaryov	グヴォズダリョフ	Гвоздарёва
Gvozdaryova	グヴォズダリョヴァ
Гдлян
Gdlyan	グドリャン	Гдляна
Gdlyana	グドリャナ
Генералов
Generalov	ゲネラロフ	Генералова
Generalova	ゲネラロヴァ
Гениатулин
Geniatulin	ゲニアトゥリン	Гениатулина
Geniatulina	ゲニアトゥリナ
Георгиевский
Georgiyevsky	ゲオルギエフスキー	Георгиевская
Georgiyevskaya	ゲオルギエフスカヤ
Герасименко
Gerasimenko	ゲラシメンコ	Герасименко
Gerasimenko	ゲラシメンコ
Герасимов
Gerasimov	ゲラシモフ	Герасимова
Gerasimova	ゲラシモヴァ
Геращенко
Gerashchenko	ゲラーシェンコ、ゲラーシチェンコ	Геращенко
Gerashchenko	ゲラーシェンコ、ゲラーシチェンコ
Гиляровский
Gilyarovsky	ギリャロフスキー	Гиляровская
Gilyarovskaya	ギリャロフスカヤ
Гитин
Gitin	ギーチン	Гитина
Gitina	ギーチナ
Гладков
Gladkov	グラトコフ	Гладкова
Gladkova	グラトコヴァ
Гладский
Gladsky	グラツキー	Гладская
Gladskaya	グラツカヤ
Глазовский
Glazovsky	グラゾフスキー	Глазовская
Glazovskaya	グラゾフスカヤ
Глазунов
Glazunov	グラズノフ、グラズノーフ	Глазунова
Glazunova	グラズノヴァ、グラズノーヴァ
Глазьев
Glazev	グラジエフ	Глазьева
Glazeva	グラジエヴァ
Глотов
Glotov	グロトフ	Глотова
Glotova	グロトヴァ
Глубоковский
Glubokovsky	グルボコフスキー	Глубоковская
Glubokovskaya	グルボコフスカヤ
Глуховский
Glukhovsky	グルホフスキー	Глуховская
Glukhovskaya	グルホフスカヤ
Глушенков
Glushenkov	グルシェンコフ	Глушенкова
Glushenkova	グルシェンコヴァ
Глущенко
Glushchenko	グルーシェンコ、グルーシチェンコ	Глущенко
Glushchenko	グルーシェンコ、グルーシチェンコ
Глыбин
Glybin	グルィビン	Глыбина
Glybina	グルィビナ
Гнездилов
Gnezdilov	グネズジロフ	Гнездилова
Gnezdilova	グネズジロヴァ
Гоболин
Gobolin	ゴボリン	Гоболина
Gobolina	ゴボリナ
Говорухин
Govorukhin	ゴヴォルーヒン	Говорухина
Govorukhina	ゴヴォルーヒナ
Гоголь
Gogol	ゴーゴリ	Гоголь
Gogol	ゴーゴリ
Голов
Golov	ゴーロフ	Голова
Golova	ゴーロヴァ
Головатов
Golovatov	ゴロヴァトフ	Головатова
Golovatova	ゴロヴァトヴァ
Головачев
Golovachev	ゴロヴァチェフ	Головачева
Golovacheva	ゴロヴァチェヴァ
Головин
Golovin	ゴロヴィン	Головина
Golovina	ゴロヴィナ
Головкин
Golovkin	ゴロフキン	Головкина
Golovkina	ゴロフキナ
Головков
Golovkov	ゴロフコフ	Головкова
Golovkova	ゴロフコヴァ
Головлёв
Golovlyov	ゴロヴリョフ	Головлёва
Golovlyova	ゴロヴリョヴァ
Голубев
Golubev	ゴールベフ	Голубева
Golubeva	ゴールベヴァ
Голубков
Golubkov	ゴルプコフ	Голубкова
Golubkova	ゴルプコヴァ
Голутов
Golutov	ゴルトフ	Голутова
Golutova	ゴルトヴァ
Голшебенко
Golshebenko	ゴルシェベンコ	Голшебенко
Golshebenko	ゴルシェベンコ
Голышев
Golyshev	ゴルィシェフ	Голышева
Golysheva	ゴルィシェヴァ
Гольбах
Golbakh	ゴリバフ	Гольбах
Golbakh	ゴリバフ
Гонжаров
Gonzharov	ゴンジャロフ	Гонжарова
Gonzharova	ゴンジャロヴァ
Гончаренко
Goncharenko	ゴンチャレンコ	Гончаренко
Goncharenko	ゴンチャレンコ
Гончаров
Goncharov	ゴンチャロフ	Гончарова
Goncharova	ゴンチャロヴァ
Горбачёв
Gorbachyov	ゴルバチョフ	Горбачёва
Gorbachyova	ゴルバチョヴァ
Горбенко
Gorbenko	ゴルベンコ	Горбенко
Gorbenko	ゴルベンコ
Горбов
Gorbov	ゴルボフ	Горбова
Gorbova	ゴルボヴァ
Горбунов
Gorbunov	ゴルブノフ	Горбунова
Gorbunova	ゴルブノヴァ
Гордеев
Gordeyev	ゴルジェーエフ	Гордеева
Gordeyeva	ゴルジェーエヴァ
Горелов
Gorelov	ゴレロフ	Горелова
Gorelova	ゴレロヴァ
Горлов
Gorlov	ゴルロフ	Горлова
Gorlova	ゴルロヴァ
Горохолинский
Gorokholinsky	ゴロホリンスキー	Горохолинская
Gorokholinskaya	ゴロホリンスカヤ
Горский
Gorsky	ゴルスキー	Горская
Gorskaya	ゴルスカヤ
Горшенков
Gorshenkov	ゴルシェンコフ	Горшенкова
Gorshenkova	ゴルシェンコヴァ
Горшков
Gorshkov	ゴルシュコフ	Горшкова
Gorshkova	ゴルシュコヴァ
Горюнов
Goryunov	ゴリュノフ	Горюнова
Goryunova	ゴリュノヴァ
Горячев
Goryachev	ゴリャチェフ	Горячева
Goryacheva	ゴリャチェヴァ
Гражданкин
Grazhdankin	グラズダンキン	Гражданкина
Grazhdankina	グラズダンキナ
Гранин
Granin	グラーニン	Гранина
Granina	グラーニナ
Гранкин
Grankin	グランキン	Гранкина
Grankina	グランキナ
Грачев
Grachev	グラチェフ	Грачева
Gracheva	グラチェヴァ
Гребенкин
Grebenkin	グレベンキン	Гребенкина
Grebenkina	グレベンキナ
Гребенников
Grebennikov	グレベンニコフ	Гребенникова
Grebennikova	グレベンニコヴァ
Греков
Grekov	グレコフ	Грекова
Grekova	グレコヴァ
Григоренко
Grigorenko	グリゴレンコ	Григоренко
Grigorenko	グリゴレンコ
Григорьев
Grigorev	グリゴリエフ	Григорьева
Grigoreva	グリゴリエヴァ
Грин
Grin	グリーン	Грина
Grina	グリーナ
Гриньков
Grinkov	グリニコフ	Гринькова
Grinkova	グリニコヴァ
Грицаев
Gritsayev	グリツァエフ	Грицаева
Gritsayeva	グリツァエヴァ
Гришин
Grishin	グリーシン	Гришина
Grishina	グリーシナ
Гришуков
Grishukov	グリシュコフ	Гришукова
Grishukova	グリシュコヴァ
Громов
Gromov	グロモフ	Громова
Gromova	グロモヴァ
Громшикин
Gromshikin	グロムシキン	Громшикина
Gromshikina	グロムシキナ
Громыко
Gromyko	グロムイコ	Громыко
Gromyko	グロムイコ
Грызунов
Gryzunov	グルィズノフ	Грызунова
Gryzunova	グルィズノヴァ
Губенко
Gubenko	グベンコ	Губенко
Gubenko	グベンコ
Губин
Gubin	グービン	Губина
Gubina	グービナ
Гужвин
Guzhvin	グズヴィン	Гужвина
Guzhvina	グズヴィナ
Гуков
Gukov	グーコフ	Гукова
Gukova	グーコヴァ
Гулидов
Gulidov	グリドフ	Гулидова
Gulidova	グリドヴァ
Гулиев
Guliyev	グリエフ	Гулиева
Guliyeva	グリエヴァ
Гуляев
Gulyayev	グリャーエフ	Гуляева
Gulyayeva	グリャーエヴァ
Гуревич
Gurevich	グレーヴィチ（グレヴィッチ）	Гуревич
Gurevich	グレーヴィチ（グレヴィッチ）
Гуркалов
Gurkalov	グルカロフ	Гуркалова
Gurkalova	グルカロヴァ
Гуров
Gurov	グーロフ	Гурова
Gurova	グーロヴァ
Гурьев
Gurev	グーリエフ	Гурьева
Gureva	グーリエヴァ
Гусаров
Gusarov	グサロフ	Гусарова
Gusarova	グサロヴァ
Гусев
Gusev	グーセフ	Гусева
Guseva	グーセヴァ
Густов
Gustov	グストフ	Густова
Gustova	グストヴァ
Гуськов
Guskov	グシコフ	Гуськова
Guskova	グシコヴァ
Гуцалов
Gutsalov	グツァロフ	Гуцалова
Gutsalova	グツァロヴァ
Гуцериев
Gutseriyev	グツェリエフ	Гуцериева
Gutseriyeva	グツェリエヴァ
Гущин
Gushchin	グーシン、グーシチン	Гущина
Gushchina	グーシナ、グーシチナ
Давиденко
Davidenko	ダヴィジェンコ	Давиденко
Davidenko	ダヴィジェンコ
Давыдкин
Davydkin	ダヴィトキン	Давыдкина
Davydkina	ダヴィトキナ
Давыдов
Davydov	ダヴィドフ	Давыдова
Davydova	ダヴィドヴァ
Данилов
Danilov	ダニロフ	Данилова
Danilova	ダニロヴァ
Данков
Dankov	ダンコフ	Данкова
Dankova	ダンコヴァ
Данченко
Danchenko	ダンチェンコ	Данченко
Danchenko	ダンチェンコ
Двуреченский
Dvurechensky	ドヴレチェンスキー	Двуреченская
Dvurechenskaya	ドヴレチェンスカヤ
Дедегкаев
Dedegkayev	ジェジェクカエフ	Дедегкаева
Dedegkayeva	ジェジェクカエヴァ
Дейнекин
Deynekin	ジェイネーキン	Дейнекина
Deynekina	ジェイネーキナ
Делидов
Delidov	ジェリドフ	Делидова
Delidova	ジェリドヴァ
Делянский
Delyansky	ジェリャンスキー	Делянская
Delyanskaya	ジェリャンスカヤ
Деменков
Demenkov	ジェメンコフ	Деменкова
Demenkova	ジェメンコヴァ
Дементьев
Dementev	ジェメーンチェフ	Дементьева
Dementeva	ジェメーンチェヴァ
Демидов
Demidov	ジェミードフ	Демидова
Demidova	ジェミードヴァ
Дёмин
Dyomin	ジョーミン	Дёмина
Dyomina	ジョーミナ
Демичев
Demichev	ジェミチェフ	Демичева
Demicheva	ジェミチェヴァ
Демченко
Demchenko	ジェムチェンコ	Демченко
Demchenko	ジェムチェンコ
Денисов
Denisov	ジェニソフ	Денисова
Denisova	ジェニソヴァ
Денисьев
Denisev	ジェニシエフ	Денисьева
Deniseva	ジェニシエヴァ
Дергачев
Dergachev	ジェルガーチェフ	Дергачева
Dergacheva	ジェルガーチェヴァ
Дерябин
Deryabin	ジェリャービン	Дерябина
Deryabina	ジェリャービナ
Дерягин
Deryagin	ジェリャーギン	Дерягина
Deryagina	ジェリャーギナ
Десятников
Desyatnikov	ジェシャートニコフ	Десятникова
Desyatnikova	ジェシャートニコヴァ
Десятов
Desyatov	ジェシャートフ	Десятова
Desyatova	ジェシャートヴァ
Детков
Detkov	ジェトコフ	Деткова
Detkova	ジェトコヴァ
Диденко
Didenko	ジジェンコ	Диденко
Didenko	ジジェンコ
Дидиченко
Didichenko	ジジチェンコ	Дидиченко
Didichenko	ジジチェンコ
Дмитриев
Dmitriyev	ドミトリエフ	Дмитриева
Dmitriyeva	ドミトリエヴァ
Добжинский
Dobzhinsky	ドブジンスキー	Добжинская
Dobzhinskaya	ドブジンスカヤ
Довлатов
Dovlatov	ドヴラートフ	Довлатова
Dovlatova	ドヴラートヴァ
Догадин
Dogadin	ドガジン	Догадина
Dogadina	ドガジナ
Догаев
Dogayev	ドガエフ	Догаева
Dogayeva	ドガエヴァ
Долгов
Dolgov	ドルゴフ	Долгова
Dolgova	ドルゴヴァ
Долголаптев
Dolgolaptev	ドルゴラプチェフ	Долголаптева
Dolgolapteva	ドルゴラプチェヴァ
Долгополов
Dolgopolov	ドルゴポロフ	Долгополова
Dolgopolova	ドルゴポロヴァ
Долгушин
Dolgushin	ドルグーシン	Долгушина
Dolgushina	ドルグーシナ
Доржиев
Dorzhiyev	ドルジエフ	Доржиева
Dorzhiyeva	ドルジエヴァ
Доровских
Dorovskikh	ドロフスキフ	Доровских
Dorovskikh	ドロフスキフ
Доронин
Doronin	ドローニン	Доронина
Doronina	ドローニナ
Дорофеев
Dorofeyev	ドロフェーエフ	Дорофеева
Dorofeyeva	ドロフェーエヴァ
Дорошенко
Doroshenko	ドロシェンコ	Дорошенко
Doroshenko	ドロシェンコ
Достоевский
Dostoyevsky	ドストエフスキー	Достоевская
Dostoyevskaya	ドストエフスカヤ
Доценко
Dotsenko	ドツェンコ	Доценко
Dotsenko	ドツェンコ
Драганов
Draganov	ドラガノフ	Драганова
Draganova	ドラガノヴァ
Дроздов
Drozdov	ドロズドフ	Дроздова
Drozdova	ドロズドヴァ
Дроков
Drokov	ドロコフ	Дрокова
Drokova	ドロコヴァ
Друбажев
Drubazhev	ドルバジェフ	Друбажева
Drubazheva	ドルバジェヴァ
Дубинин
Dubinin	ドゥビニン	Дубинина
Dubinina	ドゥビニナ
Дубровин
Dubrovin	ドゥブロヴィン	Дубровина
Dubrovina	ドゥブロヴィナ
Дудинский
Dudinsky	ドゥジンスキー	Дудинская
Dudinskaya	ドゥジンスカヤ
Думченко
Dumchenko	ドゥムチェンコ	Думченко
Dumchenko	ドゥムチェンコ
Дунаев
Dunayev	ドゥナエフ	Дунаева
Dunayeva	ドゥナエヴァ
Дурягин
Duryagin	ドゥリャーギン	Дурягина
Duryagina	ドゥリャーギナ
Дьяков
Dyakov	ジヤコフ	Дьякова
Dyakova	ジヤコヴァ
Дьяконов
Dyakonov	ジヤコノフ	Дьяконова
Dyakonova	ジヤコノヴァ
Дьяченко
Dyachenko	ジヤチェンコ	Дьяченко
Dyachenko	ジヤチェンコ
Дьячков
Dyachkov	ジヤチコフ	Дьячкова
Dyachkova	ジヤチコヴァ
Дюдяев
Dyudyayev	ジュジャエフ	Дюдяева
Dyudyayeva	ジュジャエヴァ
Дягилев
Dyagilev	ジャギレフ	Дягилева
Dyagileva	ジャギレヴァ
Дядюченко
Dyadyuchenko	ジャジュチェンコ	Дядюченко
Dyadyuchenko	ジャジュチェンコ
Евдокимов
Yevdokimov	エヴドキモフ	Евдокимова
Yevdokimova	エヴドキモヴァ
Евстигнеев
Yevstigneyev	エフスチグネーエフ	Евстигнеева
Yevstigneyeva	エフスチグネーエヴァ
Евсюков
Yevsyukov	エフシュコフ	Евсюкова
Yevsyukova	エフシュコヴァ
Евтеев
Yevteyev	エフチェーエフ	Евтеева
Yevteyeva	エフチェーエヴァ
Евтушенко
Yevtushenko	エフトゥシェンコ	Евтушенко
Yevtushenko	エフトゥシェンコ
Егин
Yegin	エーギン	Егина
Yegina	エーギナ
Егоров
Yegorov	エゴロフ	Егорова
Yegorova	エゴロヴァ
Елагин
Yelagin	エラーギン	Елагина
Yelagina	エラーギナ
Елизаров
Yelizarov	エリザロフ	Елизарова
Yelizarova	エリザロヴァ
Елисеев
Yeliseyev	エリセーエフ	Елисеева
Yeliseyeva	エリセーエヴァ
Елистратов
Yelistratov	エリストラートフ	Елистратова
Yelistratova	エリストラートヴァ
Ельцин
Yeltsin	エリツィン	Ельцина
Yeltsina	エリツィナ
Ельцов
Yeltsov	エリツォフ	Ельцова
Yeltsova	エリツォヴァ
Ельшин
Yelshin	エリシン	Ельшина
Yelshina	エリシナ
Емельянов
Yemelyanov	エメリヤノフ	Емельянова
Yemelyanova	エメリヤノヴァ
Еньков
Yenkov	エニコフ	Енькова
Yenkova	エニコヴァ
Епимахов
Yepimakhov	エピマホフ	Епимахова
Yepimakhova	エピマホヴァ
Ерёменко
Yeryomenko	エリョーメンコ	Ерёменко
Yeryomenko	エリョーメンコ
Ерёмин
Yeryomin	エリョミン、エリョーミン	Ерёмина
Yeryomina	エリョミナ、エリョーミナ
Ерёмкин
Yeryomkin	エリョームキン	Ерёмкина
Yeryomkina	エリョームキナ
Ерёмченко
Yeremchenko	エリョームチェンコ	Ерёмченко
Yeryomchenko	エリョームチェンコ
Ерин
Yerin	エーリン	Ерина
Yerina	エーリナ
Ермаков
Yermakov	エルマコフ	Ермакова
Yermakova	エルマコヴァ
Ермаченко
Yermachenko	エルマチェンコ	Ермаченко
Yermachenko	エルマチェンコ
Ермолаев
Yermolayev	エルモラーエフ	Ермолаева
Yermolayeva	エルモラーエヴァ
Ермоленко
Yermolenko	エルモレンコ	Ермоленко
Yermolenko	エルモレンコ
Ерохин
Yerokhin	エローヒン	Ерохина
Yerokhina	エローヒナ
Ерошин
Yeroshin	エローシン	Ерошина
Yeroshina	エローシナ
Ершов
Yershov	エルショフ	Ершова
Yershova	エルショヴァ
Ефимов
Yefimov	エフィーモフ	Ефимова
Yefimova	エフィーモヴァ
Ефремов
Yefremov	エフレモフ	Ефремова
Yefremova	エフレモヴァ
Жалковский
Zhalkovsky	ジャルコフスキー	Жалковская
Zhalkovskaya	ジャルコフスカヤ
Жарков
Zharkov	ジャルコフ	Жаркова
Zharkova	ジャルコヴァ
Жаров
Zharov	ジャロフ	Жарова
Zharova	ジャロヴァ
Ждакаев
Zhdakayev	ズダカーエフ	Ждакаева
Zhdakayeva	ズダカーエヴァ
Жданов
Zhdanov	ズダーノフ	Жданова
Zhdanova	ズダーノヴァ
Ждановский
Zhdanovsky	ズダノフスキー	Ждановская
Zhdanovskaya	ズダノフスカヤ
Жебелев
Zhebelev	ジェベレフ	Жебелева
Zhebeleva	ジェベレヴァ
Жебровский
Zhebrovsky	ジェブロフスキー	Жебровская
Zhebrovskaya	ジェブロフスカヤ
Жеглов
Zheglov	ジェグロフ	Жеглова
Zheglova	ジェグロヴァ
Жеков
Zhekov	ジェコフ	Жекова
Zhekova	ジェコヴァ
Жеребцов
Zherebtsov	ジェレプツォフ	Жеребцова
Zherebtsova	ジェレプツォヴァ
Жигулин
Zhigulin	ジグーリン	Жигулина
Zhigulina	ジグーリナ
Жидких
Zhidkikh	ジートキフ	Жидких
Zhidkikh	ジートキフ
Жилкин
Zhilkin	ジルキン	Жилкина
Zhilkina	ジルキナ
Жильцов
Zhiltsov	ジリツォフ	Жильцова
Zhiltsova	ジリツォヴァ
Жириновский
Zhirinovsky	ジリノフスキー	Жириновская
Zhirinovskaya	ジリノフスカヤ
Жирков
Zhirkov	ジルコフ	Жиркова
Zhirkova	ジルコヴァ
Житников
Zhitnikov	ジトニコフ	Житникова
Zhitnikova	ジトニコヴァ
Жокин
Zhokin	ジョキン	Жокина
Zhokina	ジョキナ
Жочкин
Zhochkin	ジョチキン	Жочкина
Zhochkina	ジョチキナ
Жуков
Zhukov	ジューコフ	Жукова
Zhukova	ジューコヴァ
Жуковский
Zhukovsky	ジュコフスキー	Жуковская
Zhukovskaya	ジュコフスカヤ
Журавков
Zhuravkov	ジュラフコフ	Журавкова
Zhuravkova	ジュラフコヴァ
Журавлёв
Zhuravlyov	ジュラヴリョフ	Журавлёва
Zhuravlyova	ジュラヴリョヴァ
Журавский
Zhuravsky	ジュラフスキー	Журавская
Zhuravskaya	ジュラフスカヤ
Жураковский
Zhurakovsky	ジュラコフスキー	Жураковская
Zhurakovskaya	ジュラコフスカヤ
Заботкин
Zabotkin	ザボトキン	Заботкина
Zabotkina	ザボトキナ
Заварыкин
Zavarykin	ザヴァルィキン	Заварыкина
Zavarykina	ザヴァルィキナ
Заверюха
Zaveryukha	ザヴェリューハ	Заверюха
Zaveryukha	ザヴェリューハ
Задонский
Zadonsky	ザドンスキー	Задонская
Zadonskaya	ザドンスカヤ
Задорнов
Zadornov	ザドルノフ	Задорнова
Zadornova	ザドルノヴァ
Зайцев
Zaytsev	ザイツェフ	Зайцева
Zaytseva	ザイツェヴァ
Заклинский
Zaklinsky	ザクリンスキー	Заклинская
Zaklinskaya	ザクリンスカヤ
Замотин
Zamotin	ザモチン	Замотина
Zamotina	ザモチナ
Замятин
Zamyatin	ザミャーチン	Замятина
Zamyatina	ザミャーチナ
Запольский
Zapolsky	ザポリスキー	Запольская
Zapolskaya	ザポリスカヤ
Зараменский
Zaramensky	ザラメンスキー	Зараменская
Zaramenskaya	ザラメンスカヤ
Заричанский
Zarichansky	ザリチャンスキー	Заричанская
Zarichanskaya	ザリチャンスカヤ
Заславский
Zaslavsky	ザスラフスキー	Заславская
Zaslavskaya	ザスラフスカヤ
Засухин
Zasukhin	ザスーヒン	Засухина
Zasukhina	ザスーヒナ
Затулин
Zatulin	ザトゥーリン	Затулина
Zatulina	ザトゥーリナ
Захаров
Zakharov	ザハロフ	Захарова
Zakharova	ザハロヴァ
Звенигородский
Zvenigorodsky	ズヴェニゴロツキー	Звенигородская
Zvenigorodskaya	ズヴェニゴロツカヤ
Зверев
Zverev	ズヴェーレフ	Зверева
Zvereva	ズヴェーレヴァ
Зверховский
Zverkhovsky	ズヴェルホフスキー	Зверховская
Zverkhovskaya	ズヴェルホフスカヤ
Зволинский
Zvolinsky	ズヴォリンスキー	Зволинская
Zvolinskaya	ズヴォリンスカヤ
Звягин
Zvyagin	ズヴャーギン	Звягина
Zvyagina	ズヴャーギナ
Зеленин
Zelenin	ゼレーニン	Зеленина
Zelenina	ゼレーニナ
Зеленкин
Zelenkin	ゼレンキン	Зеленкина
Zelenkina	ゼレンキナ
Зеленов
Zelenov	ゼレノフ	Зеленова
Zelenova	ゼレノヴァ
Зеленский
Zelensky	ゼレンスキー	Зеленская
Zelenskaya	ゼレンスカヤ
Зенкин
Zenkin	ゼンキン	Зенкина
Zenkina	ゼンキナ
Зеренков
Zerenkov	ゼレンコフ	Зеренкова
Zerenkova	ゼレンコヴァ
Зерин
Zerin	ゼーリン	Зерина
Zerina	ゼーリナ
Зиланов
Zilanov	ジラーノフ	Зиланова
Zilanova	ジラーノヴァ
Зимин
Zimin	ジミーン	Зимина
Zimina	ジミーナ
Зиновьев
Zinovev	ジノヴィエフ	Зиновьева
Zinoveva	ジノヴィエヴァ
Злобин
Zlobin	ズロービン	Злобина
Zlobina	ズロービナ
Золотарёв
Zolotaryov	ゾロタリョフ	Золотарёва
Zolotaryova	ゾロタリョヴァ
Золотов
Zolotov	ゾロトフ	Золотова
Zolotova	ゾロトヴァ
Золотухин
Zolotukhin	ゾロトゥーヒン	Золотухина
Zolotukhina	ゾロトゥーヒナ
Зорин
Zorin	ゾーリン	Зорина
Zorina	ゾーリナ
Зоркальцев
Zorkaltsev	ゾルカリツェフ	Зоркальцева
Zorkaltseva	ゾルカリツェヴァ
Зотиков
Zotikov	ゾチコフ	Зотикова
Zotikova	ゾチコヴァ
Зотин
Zotin	ゾーチン	Зотина
Zotina	ゾーチナ
Зощенко
Zoshchenko	ゾーシェンコ、ゾーシチェンコ	Зощенко
Zoshchenko	ゾーシェンコ、ゾーシチェンコ
Зубакин
Zubakin	ズバーキン	Зубакина
Zubakina	ズバーキナ
Зубаков
Zubakov	ズバコフ	Зубакова
Zubakova	ズバコヴァ
Зубков
Zubkov	ズプコフ	Зубкова
Zubkova	ズプコヴァ
Зубковский
Zubkovsky	ズプコフスキー	Зубковская
Zubkovskaya	ズプコフスカヤ
Зубов
Zubov	ズーボフ	Зубова
Zubova	ズーボヴァ
Зуев
Zuyev	ズーエフ	Зуева
Zuyeva	ズーエヴァ
Зурабов
Zurabov	ズラボフ	Зурабова
Zurabova	ズラボヴァ
Зыков
Zykov	ズィーコフ	Зыкова
Zykova	ズィーコヴァ
Зюганов
Zyuganov	ジュガノフ	Зюганова
Zyuganova	ジュガノヴァ
Зяблицев
Zyablitsev	ジャブリツェフ	Зяблицева
Zyablitseva	ジャブリツェヴァ
Зяблов
Zyablov	ジャブロフ	Зяблова
Zyablova	ジャブロヴァ
Ивакин
Ivakin	イヴァキン	Ивакина
Ivakina	イヴァキナ
Иваненко
Ivanenko	イヴァネンコ	Иваненко
Ivanenko	イヴァネンコ
Иванов
Ivanov	イヴァノフ（イワノフ）	Иванова
Ivanova	イヴァノヴァ
Ивантаев
Ivantayev	イヴァンタエフ	Ивантаева
Ivantayeva	イヴァンタエヴァ
Иванченко
Ivanchenko	イヴァンチェンコ	Иванченко
Ivanchenko	イヴァンチェンコ
Иванюта
Ivanyuta	イヴァニュタ	Иванюта
Ivanyuta	イヴァニュタ
Ивлев
Ivlev	イヴレフ	Ивлева
Ivleva	イヴレヴァ
Ивонин
Ivonin	イヴォニン	Ивонина
Ivonina	イヴォニナ
Игнатенко
Ignatenko	イグナチェンコ	Игнатенко
Ignatenko	イグナチェンコ
Игнатков
Ignatkov	イグナトコフ	Игнаткова
Ignatkova	イグナトコヴァ
Игнатов
Ignatov	イグナートフ	Игнатова
Ignatova	イグナートヴァ
Игнатьев
Ignatev	イグナーチェフ	Игнатьева
Ignateva	イグナーチェヴァ
Игрунов
Igrunov	イグルノフ	Игрунова
Igrunova	イグルノヴァ
Игумнов
Igumnov	イグムノフ	Игумнова
Igumnova	イグムノヴァ
Иевлев
Iyevlev	イエヴレフ	Иевлева
Iyevleva	イエヴレヴァ
Иконников
Ikonnikov	イコンニコフ	Иконникова
Ikonnikova	イコンニコヴァ
Илларионов
Illarionov	イッラリオーノフ	Илларионова
Illarionova	イッラリオーノヴァ
Иловский
Ilovsky	イロフスキー	Иловская
Ilovskaya	イロフスカヤ
Ильенков
Ilenkov	イリエンコフ	Ильенкова
Ilenkova	イリエンコヴァ
Ильин
Ilyin	イリイーン	Ильина
Ilyina	イリイーナ
Ильинский
Ilyinsky	イリインスキー	Ильинская
Ilyinskaya	イリインスカヤ
Ильичев
Ilyichev	イリイチェフ	Ильичева
Ilyicheva	イリイチェヴァ
Ильюшенко
Ilyushenko	イリユシェンコ	Ильюшенко
Ilyushenko	イリユシェンコ
Илюхин
Ilyukhin	イリューヒン	Илюхина
Ilyukhina	イリューヒナ
Илюшечкин
Ilyushechkin	イリュシェチキン	Илюшечкина
Ilyushechkina	イリュシェチキナ
Илюшин
Ilyushin	イリューシン	Илюшина
Ilyushina	イリューシナ
Имедоев
Imedoyev	イメドエフ	Имедоева
Imedoyeva	イメドエヴァ
Ионов
Ionov	イオーノフ	Ионова
Ionova	イオーノヴァ
Ипполитов
Ippolitov	イッポリートフ	Ипполитова
Ippolitova	イッポリートヴァ
Исаев
Isayev	イサエフ	Исаева
Isayeva	イサエヴァ
Исаков
Isakov	イサコフ	Исакова
Isakova	イサコヴァ
Исправников
Ispravnikov	イスプラーヴニコフ	Исправникова
Ispravnikova	イスプラーヴニコヴァ
Ишаев
Ishayev	イシャエフ	Ишаева
Ishayeva	イシャエヴァ
Ищенко
Ishchenko	イーシェンコ、イーシチェンコ	Ищенко
Ishchenko	イーシェンコ、イーシチェンコ
Кабаев
Kabayev	カバエフ	Кабаева
Kabayeva	カバエヴァ
Кабаков
Kabakov	カバコフ	Кабакова
Kabakova	カバコヴァ
Кабанов
Kabanov	カバノフ	Кабанова
Kabanova	カバノヴァ
Каверин
Kaverin	カヴェーリン	Каверина
Kaverina	カヴェーリナ
Кагаловский
Kagalovsky	カガロフスキー	Кагаловская
Kagalovskaya	カガロフスカヤ
Каданников
Kadannikov	カダンニコフ	Каданникова
Kadannikova	カダンニコヴァ
Кадочников
Kadochnikov	カドチニコフ、カードチニコフ	Кадочникова
Kadochnikova	カドチニコヴァ、カードチニコヴァ
Казаков
Kazakov	カザコフ	Казакова
Kazakova	カザコヴァ
Казаковцев
Kazakovtsev	カザコフツェフ	Казаковцева
Kazakovtseva	カザコフツェヴァ
Казанцев
Kazantsev	カザンツェフ	Казанцева
Kazantseva	カザンツェヴァ
Казаров
Kazarov	カザロフ	Казарова
Kazarova	カザロヴァ
Казьмин
Kazmin	カジミン	Казьмина
Kazmina	カジミナ
Каландин
Kalandin	カランジン	Каландина
Kalandina	カランジナ
Калатозов
Kalatozov	カラトーゾフ	Калатозова
Kalatozova	カラトーゾヴァ
Калашников
Kalashnikov	カラーシュニコフ（カラシニコフ）	Калашникова
Kalashnikova	カラーシュニコヴァ
Калин
Kalin	カーリン	Калина
Kalina	カーリナ
Калинин
Kalinin	カリーニン	Калинина
Kalinina	カリーニナ
Калистратов
Kalistratov	カリストラトフ	Калистратова
Kalistratova	カリストラトヴァ
Калмыков
Kalmykov	カルムイコフ	Калмыкова
Kalmykova	カルムイコヴァ
Калягин
Kalyagin	カリャーギン	Калягина
Kalyagina	カリャーギナ
Каменев
Kamenev	カメネフ	Каменева
Kameneva	カメネヴァ
Каминский
Kaminsky	カミンスキー	Каминская
Kaminskaya	カミンスカヤ
Камышинский
Kamyshinsky	カムイシンスキー	Камышинская
Kamyshinskaya	カムイシンスカヤ
Канаев
Kanayev	カナーエフ	Канаева
Kanayeva	カナーエヴァ
Кандаков
Kandakov	カンダコフ	Кандакова
Kandakova	カンダコヴァ
Кандинский
Kandinsky	カンジンスキー（カンディンスキー）	Кандинская
Kandinskaya	カンジンスカヤ
Кантемиров
Kantemirov	カンチェミロフ	Кантемирова
Kantemirova	カンチェミロヴァ
Капустин
Kapustin	カプスチン	Капустина
Kapustina	カプスチナ
Караганов
Karaganov	カラガノフ	Караганова
Karaganova	カラガノヴァ
Карамзин
Karamzin	カラムジン	Карамзина
Karamzina	カラムジナ
Карасин
Karasin	カラシン	Карасина
Karasina	カラシナ
Карастин
Karastin	カラスチン	Карастина
Karastina	カラスチナ
Карачурин
Karachurin	カラチュリン	Карачурина
Karachurina	カラチュリナ
Карбовский
Karbovsky	カルボフスキー	Карбовская
Karbovskaya	カルボフスカヤ
Карганов
Karganov	カルガノフ	Карганова
Karganova	カルガノヴァ
Карев
Karev	カーレフ	Карева
Kareva	カーレヴァ
Карелин
Karelin	カレーリン	Карелина
Karelina	カレーリナ
Каримов
Karimov	カリモフ	Каримова
Karimova	カリモヴァ
Карлов
Karlov	カルロフ	Карлова
Karlova	カルロヴァ
Карнаух
Karnaukh	カルナウフ	Карнаух
Karnaukh	カルナウフ
Карнаухов
Karnaukhov	カルナウホフ	Карнаухова
Karnaukhova	カルナウホヴァ
Карпов
Karpov	カルポフ	Карпова
Karpova	カルポヴァ
Карсавин
Karsavin	カルサーヴィン	Карсавина
Karsavina	カルサーヴィナ
Карташов
Kartashov	カルタショフ	Карташова
Kartashova	カルタショヴァ
Карякин
Karyakin	カリャキン	Карякина
Karyakina	カリャキナ
Касымов
Kasymov	カスィモフ	Касымова
Kasymova	カスィモヴァ
Касьянов
Kasyanov	カシヤノフ	Касьянова
Kasyanova	カシヤノヴァ
Катаев
Katayev	カターエフ	Катаева
Katayeva	カターエヴァ
Катальников
Katalnikov	カタリニコフ	Катальникова
Katalnikova	カタリニコヴァ
Катанандов
Katanandov	カタナンドフ	Катанандова
Katanandova	カタナンドヴァ
Катренко
Katrenko	カトレンコ	Катренко
Katrenko	カトレンコ
Катульский
Katulsky	カトゥリスキー	Катульская
Katulskaya	カトゥリスカヤ
Кауров
Kaurov	カウロフ	Каурова
Kaurova	カウロヴァ
Кацалапов
Katsalapov	カツァラポフ	Кацалапова
Katsalapova	カツァラポヴァ
Качанов
Kachanov	カチャノフ	Качанова
Kachanova	カチャノヴァ
Качимов
Kachimov	カチモフ	Качимова
Kachimova	カチモヴァ
Кашпировский
Kashpirovsky	カシュピローフスキー	Кашпировская
Kashpirovskaya	カシュピローフスカヤ
Квасов
Kvasov	クヴァソフ	Квасова
Kvasova	クヴァソヴァ
Квашнин
Kvashnin	クヴァシュニン	Квашнина
Kvashnina	クヴァシュニナ
Кедровский
Kedrovsky	ケドロフスキー	Кедровская
Kedrovskaya	ケドロフスカヤ
Кекишев
Kekishev	ケキシェフ	Кекишева
Kekisheva	ケキシェヴァ
Кечкин
Kechkin	ケチキン	Кечкина
Kechkina	ケチキナ
Кибериев
Kiberiyev	キベリエフ	Кибериева
Kiberiyeva	キベリエヴァ
Кибирев
Kibirev	キービレフ	Кибирева
Kibireva	キービレヴァ
Киренинов
Kireninov	キレニノフ	Киренинова
Kireninova	キレニノヴァ
Кириенко
Kiriyenko	キリエンコ	Кириенко
Kiriyenko	キリエンコ
Кириличев
Kirilichev	キリリチェフ	Кириличева
Kirilicheva	キリリチェヴァ
Кириллов
Kirillov	キリーロフ	Кириллова
Kirillova	キリーロヴァ
Кириченко
Kirichenko	キリチェンコ	Кириченко
Kirichenko	キリチェンコ
Кирпичников
Kirpichnikov	キルピチニコフ	Кирпичникова
Kirpichnikova	キルピチニコヴァ
Кирьяков
Kiryakov	キリヤコフ	Кирьякова
Kiryakova	キリヤコヴァ
Киселёв
Kiselyov	キセリョフ	Киселёва
Kiselyova	キセリョヴァ
Кисин
Kisin	キーシン	Кисина
Kisina	キーシナ
Кислицын
Kislitsyn	キスリツィン	Кислицына
Kislitsyna	キスリツィナ
Клевцов
Klevtsov	クレフツォフ	Клевцова
Klevtsova	クレフツォヴァ
Клименко
Klimenko	クリメンコ	Клименко
Klimenko	クリメンコ
Климов
Klimov	クリモフ	Климова
Klimova	クリモヴァ
Клинов
Klinov	クリノフ	Клинова
Klinova	クリノヴァ
Клочков
Klochkov	クロチコフ	Клочкова
Klochkova	クロチコヴァ
Ключников
Klyuchnikov	クリュチニコフ	Ключникова
Klyuchnikova	クリュチニコヴァ
Княжев
Knyazhev	クニャジェフ	Княжева
Knyazheva	クニャジェヴァ
Князев
Knyazev	クニャーゼフ	Князева
Knyazeva	クニャーゼヴァ
Кобелев
Kobelev	コベレフ	Кобелева
Kobeleva	コベレヴァ
Кобылкин
Kobylkin	コブィルキン、コビルキン	Кобылкина
Kobylkina	コブィルキナ、コビルキナ
Ковалёв
Kovalyov	コヴァリョフ	Ковалёва
Kovalyova	コヴァリョヴァ
Ковалевский
Kovalevsky	コヴァレフスキー	Ковалевская
Kovalevskaya	コヴァレフスカヤ
Коваленко
Kovalenko	コヴァレンコ	Коваленко
Kovalenko	コヴァレンコ
Ковальский
Kovalsky	コヴァリスキー	Ковальская
Kovalskaya	コヴァリスカヤ
Коврижных
Kovrizhnykh	コヴリーズヌィフ	Коврижных
Kovrizhnykh	コヴリーズヌィフ
Кожевников
Kozhevnikov	コジェヴニコフ	Кожевникова
Kozhevnikova	コジェヴニコヴァ
Кожемякин
Kozhemyakin	コジェミャキン	Кожемякина
Kozhemyakina	コジェミャキナ
Кожокин
Kozhokin	コジョーキン	Кожокина
Kozhokina	コジョーキナ
Кожухов
Kozhukhov	コジュホフ	Кожухова
Kozhukhova	コジュホヴァ
Козерадский
Kozeradsky	コゼラツキー	Козерадская
Kozeradskaya	コゼラツカヤ
Козлов
Kozlov	コズロフ	Козлова
Kozlova	コズロヴァ
Козырев
Kozyrev	コーズィレフ	Козырева
Kozyreva	コーズィレヴァ
Коков
Kokov	コーコフ	Кокова
Kokova	コーコヴァ
Кокорев
Kokorev	コーコレフ	Кокорева
Kokoreva	コーコレヴァ
Кокошин
Kokoshin	ココーシン	Кокошина
Kokoshina	ココーシナ
Колбасов
Kolbasov	コルバソフ	Колбасова
Kolbasova	コルバソヴァ
Колганов
Kolganov	コルガノフ	Колганова
Kolganova	コルガノヴァ
Колегов
Kolegov	コーレゴフ	Колегова
Kolegova	コーレゴヴァ
Колесников
Kolesnikov	コレスニコフ	Колесникова
Kolesnikova	コレスニコヴァ
Колесниченко
Kolesnichenko	コレスニチェンコ	Колесниченко
Kolesnichenko	コレスニチェンコ
Колиниченко
Kolinichenko	コリニチェンコ	Колиниченко
Kolinichenko	コリニチェンコ
Колмаков
Kolmakov	コルマコフ	Колмакова
Kolmakova	コルマコヴァ
Колобов
Kolobov	コーロボフ	Колобова
Kolobova	コーロボヴァ
Кологолов
Kologolov	コロゴロフ	Кологолова
Kologolova	コロゴロヴァ
Колодезников
Kolodeznikov	コロジェズニコフ	Колодезникова
Kolodeznikova	コロジェズニコヴァ
Колоколов
Kolokolov	コロコロフ	Колоколова
Kolokolova	コロコロヴァ
Коломейцев
Kolomeytsev	コロメイツェフ	Коломейцева
Kolomeytseva	コロメイツェヴァ
Коломенкин
Kolomenkin	コロメンキン	Коломенкина
Kolomenkina	コロメンキナ
Колосов
Kolosov	コロソフ	Колосова
Kolosova	コロソヴァ
Колпаков
Kolpakov	コルパコフ	Колпакова
Kolpakova	コルパコヴァ
Колтаков
Koltakov	コルタコフ	Колтакова
Koltakova	コルタコヴァ
Комаров
Komarov	コマロフ	Комарова
Komarova	コマロヴァ
Комаровский
Komarovsky	コマロフスキー	Комаровская
Komarovskaya	コマロフスカヤ
Комиссаров
Komissarov	コミッサーロフ	Комиссарова
Komissarova	コミッサーロヴァ
Комлев
Komlev	コムレフ	Комлева
Komleva	コムレヴァ
Комов
Komov	コーモフ	Комова
Komova	コーモヴァ
Компанцев
Kompantsev	コンパンツェフ	Компанцева
Kompantseva	コンパンツェヴァ
Комчатов
Komchatov	コムチャトフ	Комчатова
Komchatova	コムチャトヴァ
Конаков
Konakov	コナコフ	Конакова
Konakova	コナコヴァ
Кондаков
Kondakov	コンダコフ	Кондакова
Kondakova	コンダコヴァ
Кондауров
Kondaurov	コンダウロフ	Кондаурова
Kondaurova	コンダウロヴァ
Кондратенко
Kondratenko	コンドラチェンコ	Кондратенко
Kondratenko	コンドラチェンコ
Кондратов
Kondratov	コンドラトフ	Кондратова
Kondratova	コンドラトヴァ
Кондратьев
Kondratev	コンドラーチェフ	Кондратьева
Kondrateva	コンドラーチェヴァ
Кондрашов
Kondrashov	コンドラショフ	Кондрашова
Kondrashova	コンドラショヴァ
Коновалов
Konovalov	コノヴァロフ	Коновалова
Konovalova	コノヴァロヴァ
Кононов
Kononov	コーノノフ	Кононова
Kononova	コーノノヴァ
Константинов
Konstantinov	コンスタンチノフ	Константинова
Konstantinova	コンスタンチノヴァ
Кончаловский
Konchalovsky	コンチャロフスキー	Кончаловская
Konchalovskaya	コンチャロフスカヤ
Копейкин
Kopeykin	コペイキン	Копейкина
Kopeykina	コペイキナ
Копсов
Kopsov	コプソフ	Копсова
Kopsova	コプソヴァ
Коптев
Koptev	コプチェフ	Коптева
Kopteva	コプチェヴァ
Копылов
Kopylov	コプィロフ	Копылова
Kopylova	コプィロヴァ
Корабельщиков
Korabelshchikov	コラベリシコフ、コラベリシチコフ	Корабельщикова
Korabelshchikova	コラベリシコヴァ、コラベリシチコヴァ
Корельский
Korelsky	コレリスキー	Корельская
Korelskaya	コレリスカヤ
Корепанов
Korepanov	コレパノフ	Корепанова
Korepanova	コレパノヴァ
Коржаков
Korzhakov	コルジャコフ	Коржакова
Korzhakova	コルジャコヴァ
Корниенко
Korniyenko	コルニエンコ	Корниенко
Korniyenko	コルニエンコ
Корнилов
Kornilov	コルニーロフ	Корнилова
Kornilova	コルニーロヴァ
Коробейников
Korobeynikov	コロベイニコフ	Коробейникова
Korobeynikova	コロベイニコヴァ
Коробицин
Korobitsin	コロビツィン	Коробицина
Korobitsina	コロビツィナ
Коробка
Korobka	コロープカ	Коробка
Korobka	コロープカ
Коробов
Korobov	コロボフ	Коробова
Korobova	コロボヴァ
Коробченко
Korobchenko	コロプチェンコ	Коробченко
Korobchenko	コロプチェンコ
Коровкин
Korovkin	コロフキン	Коровкина
Korovkina	コロフキナ
Коровников
Korovnikov	コロヴニコフ	Коровникова
Korovnikova	コロヴニコヴァ
Королёв
Korolyov	コロリョーフ	Королёва
Korolyova	コロリョーヴァ
Короленко
Korolenko	コロレンコ	Короленко
Korolenko	コロレンコ
Коротков
Korotkov	コロトコフ	Короткова
Korotkova	コロトコヴァ
Корочин
Korochin	コロチン	Корочина
Korochina	コロチナ
Корпачев
Korpachev	コルパチェフ	Корпачева
Korpacheva	コルパチェヴァ
Корсаков
Korsakov	コルサコフ	Корсакова
Korsakova	コルサコヴァ
Корсун
Korsun	コルスン	Корсуна
Korsuna	コルスナ
Корсунов
Korsunov	コルスノフ	Корсунова
Korsunova	コルスノヴァ
Корсунцев
Korsuntsev	コルスンツェフ	Корсунцева
Korsuntseva	コルスンツェヴァ
Корчагин
Korchagin	コルチャーギン	Корчагина
Korchagina	コルチャーギナ
Коршунов
Korshunov	コルシュノフ	Коршунова
Korshunova	コルシュノヴァ
Косариков
Kosarikov	コサリコフ	Косарикова
Kosarikova	コサリコヴァ
Косенко
Kosenko	コセンコ	Косенко
Kosenko	コセンコ
Косиков
Kosikov	コシコフ	Косикова
Kosikova	コシコヴァ
Косопкин
Kosopkin	コソプキン	Косопкина
Kosopkina	コソプキナ
Коссов
Kossov	コッソフ	Коссова
Kossova	コッソヴァ
Костенко
Kostenko	コスチェンコ	Костенко
Kostenko	コスチェンコ
Костерин
Kosterin	コスチェリン	Костерина
Kosterina	コスチェリナ
Костиков
Kostikov	コスチコフ	Костикова
Kostikova	コスチコヴァ
Костин
Kostin	コスチン	Костина
Kostina	コスチナ
Костомаров
Kostomarov	コストマロフ	Костомарова
Kostomarova	コストマロヴァ
Костырин
Kostyrin	コストィリン	Костырина
Kostyrina	コストィリナ
Костюнин
Kostyunin	コスチュニン	Костюнина
Kostyunina	コスチュニナ
Костюткин
Kostyutkin	コスチュトキン	Костюткина
Kostyutkina	コスチュトキナ
Костюченко
Kostyuchenko	コスチュチェンコ	Костюченко
Kostyuchenko	コスチュチェンコ
Косых
Kosykh	コスィフ	Косых
Kosykh	コスィフ
Котелкин
Kotelkin	コチェルキン	Котелкина
Kotelkina	コチェルキナ
Котенёв
Kotenyov	コチェニョーフ	Котенёва
Kotenyova	コチェニョーヴァ
Котенков
Kotenkov	コチェンコフ	Котенкова
Kotenkova	コチェンコヴァ
Котков
Kotkov	コトコフ	Коткова
Kotkova	コトコヴァ
Котляров
Kotlyarov	コトリャロフ	Котлярова
Kotlyarova	コトリャロヴァ
Котов
Kotov	コートフ、コトフ	Котова
Kotova	コートヴァ、コトヴァ
Котюсов
Kotyusov	コチュソフ	Котюсова
Kotyusova	コチュソヴァ
Кочегура
Kochegura	コチェグラ	Кочегура
Kochegura	コチェグラ
Кочергин
Kochergin	コチェルギン	Кочергина
Kochergina	コチェルギナ
Кошелев
Koshelev	コーシェレフ	Кошелева
Kosheleva	コーシェレヴァ
Кошкин
Koshkin	コシュキン、コーシュキン	Кошкина
Koshkina	コシュキナ、コーシュキナ
Кравцов
Kravtsov	クラフツォフ	Кравцова
Kravtsova	クラフツォヴァ
Крайнев
Kraynev	クライネフ	Крайнева
Krayneva	クライネヴァ
Крапивин
Krapivin	クラピヴィン	Крапивина
Krapivina	クラピヴィナ
Красавченко
Krasavchenko	クラサフチェンコ	Красавченко
Krasavchenko	クラサフチェンコ
Красиков
Krasikov	クラシコフ	Красикова
Krasikova	クラシコヴァ
Красильников
Krasilnikov	クラシーリニコフ	Красильникова
Krasilnikova	クラシーリニコヴァ
Красников
Krasnikov	クラスニコフ	Красникова
Krasnikova	クラスニコヴァ
Краснов
Krasnov	クラスノフ	Краснова
Krasnova	クラスノヴァ
Краснопивцев
Krasnopivtsev	クラスノピフツェフ	Краснопивцева
Krasnopivtseva	クラスノピフツェヴァ
Краснояров
Krasnoyarov	クラスノヤロフ	Красноярова
Krasnoyarova	クラスノヤロヴァ
Красных
Krasnykh	クラスヌィフ	Красных
Krasnykh	クラスヌィフ
Крашенинников
Krasheninnikov	クラシェニンニコフ	Крашенинникова
Krasheninnikova	クラシェニンニコヴァ
Крестьянинов
Krestyaninov	クレスチヤニノフ	Крестьянинова
Krestyaninova	クレスチヤニノヴァ
Кривелёв
Krivelyov	クリヴェリョフ	Кривелёва
Krivelyova	クリヴェリョヴァ
Кривов
Krivov	クリヴォフ	Кривова
Krivova	クリヴォヴァ
Кривошапкин
Krivoshapkin	クリヴォシャプキン	Кривошапкина
Krivoshapkina	クリヴォシャプキナ
Кривченко
Krivchenko	クリフチェンコ	Кривченко
Krivchenko	クリフチェンコ
Кропоткин
Kropotkin	クロポトキン	Кропоткина
Kropotkina	クロポトキナ
Кропотов
Kropotov	クロポトフ	Кропотова
Kropotova	クロポトヴァ
Кругликов
Kruglikov	クルグリコフ	Кругликова
Kruglikova	クルグリコヴァ
Круглов
Kruglov	クルグロフ	Круглова
Kruglova	クルグロヴァ
Крупнов
Krupnov	クルプノフ	Крупнова
Krupnova	クルプノヴァ
Крутых
Krutykh	クルトィフ	Крутых
Krutykh	クルトィフ
Крушинский
Krushinsky	クルシンスキー	Крушинская
Krushinskaya	クルシンスカヤ
Крылов
Krylov	クルィロフ	Крылова
Krylova	クルィロヴァ
Крысяев
Krysyayev	クルィシャエフ	Крысяева
Krysyayeva	クルィシャエヴァ
Крюков
Kryukov	クリューコフ	Крюкова
Kryukova	クリューコヴァ
Крючков
Kryuchkov	クリュチコフ	Крючкова
Kryuchkova	クリュチコヴァ
Кубарев
Kubarev	クーバレフ	Кубарева
Kubareva	クーバレヴァ
Куваев
Kuvayev	クヴァエフ	Куваева
Kuvayeva	クヴァエヴァ
Кувшинов
Kuvshinov	クフシノフ	Кувшинова
Kuvshinova	クフシノヴァ
Кудинов
Kudinov	クジノフ	Кудинова
Kudinova	クジノヴァ
Кудрин
Kudrin	クドリン	Кудрина
Kudrina	クドリナ
Кудрявцев
Kudryavtsev	クドリャーフツェフ	Кудрявцева
Kudryavtseva	クドリャーフツェヴァ
Кудряшов
Kudryashov	クドリャショーフ	Кудряшова
Kudryashova	クドリャショーヴァ
Кузенков
Kuzenkov	クゼンコフ	Кузенкова
Kuzenkova	クゼンコヴァ
Кузин
Kuzin	クージン	Кузина
Kuzina	クージナ
Кузмин
Kuzmin	クズミン	Кузмина
Kuzmina	クズミナ
Кузнецов
Kuznetsov	クズネツォフ	Кузнецова
Kuznetsova	クズネツォヴァ
Кузнечов
Kuznechov	クズネチョフ	Кузнечова
Kuznechova	クズネチョヴァ
Кузьмин
Kuzmin	クジミン	Кузьмина
Kuzmina	クジミナ
Кузьмичев
Kuzmichev	クジミチェフ	Кузьмичева
Kuzmicheva	クジミチェヴァ
Кузюков
Kuzyukov	クジュコフ	Кузюкова
Kuzyukova	クジュコヴァ
Кулагин
Kulagin	クラーギン	Кулагина
Kulagina	クラーギナ
Кулаков
Kulakov	クラコーフ	Кулакова
Kulakova	クラコーヴァ
Кулаковский
Kulakovsky	クラコフスキー	Кулаковская
Kulakovskaya	クラコフスカヤ
Кулёмин
Kulyomin	クリョーミン	Кулёмина
Kulyomina	クリョーミナ
Кулешев
Kuleshev	クレシェフ	Кулешева
Kulesheva	クレシェヴァ
Куликов
Kulikov	クリコフ	Куликова
Kulikova	クリコヴァ
Кульечев
Kulechev	クリエチェフ	Кульечева
Kulecheva	クリエチェヴァ
Кунин
Kunin	クーニン	Кунина
Kunina	クーニナ
Куприн
Kuprin	クプリーン、クプリン	Куприна
Kuprina	クプリーナ、クプリナ
Куприяновский
Kupriyanovsky	クプリヤノフスキー	Куприяновская
Kupriyanovskaya	クプリヤノフスカヤ
Купцов
Kuptsov	クプツォフ	Купцова
Kuptsova	クプツォヴァ
Кураков
Kurakov	クラコフ	Куракова
Kurakova	クラコヴァ
Курамин
Kuramin	クラミン	Курамина
Kuramina	クラミナ
Куранов
Kuranov	クラノフ	Куранова
Kuranova	クラノヴァ
Курбатов
Kurbatov	クルバトフ	Курбатова
Kurbatova	クルバトヴァ
Кургапкин
Kurgapkin	クルガープキン	Кургапкина
Kurgapkina	クルガープキナ
Куренков
Kurenkov	クレンコフ	Куренкова
Kurenkova	クレンコヴァ
Курин
Kurin	クーリン	Курина
Kurina	クーリナ
Курицын
Kuritsyn	クリツィン	Курицына
Kuritsyna	クリツィナ
Курников
Kurnikov	クルニコフ	Курникова
Kurnikova	クルニコヴァ
Куропаткин
Kuropatkin	クロパトキン	Куропаткина
Kuropatkina	クロパトキナ
Курочкин
Kurochkin	クロチキン	Курочкина
Kurochkina	クロチキナ
Куртин
Kurtin	クルチン	Куртина
Kurtina	クルチナ
Кутафин
Kutafin	クタフィン	Кутафина
Kutafina	クタフィナ
Кутуков
Kutukov	クトゥコフ	Кутукова
Kutukova	クトゥコヴァ
Кучинский
Kuchinsky	クチンスキー	Кучинская
Kuchinskaya	クチンスカヤ
Кшесинский
Kshesinsky	クシェシンスキー	Кшесинская
Kshesinskaya	クシェシンスカヤ
Лаврентьев
Lavrentev	ラヴレーンチェフ	Лаврентьева
Lavrenteva	ラヴレーンチェヴァ
Лавров
Lavrov	ラヴローフ	Лаврова
Lavrova	ラヴローヴァ
Лавровский
Lavrovsky	ラヴロフスキー	Лавровская
Lavrovskaya	ラヴロフスカヤ
Ладыгин
Ladygin	ラドィギン	Ладыгина
Ladygina	ラドィギナ
Лазарев
Lazarev	ラーザレフ、ラザレフ	Лазарева
Lazareva	ラーザレヴァ、ラザレヴァ
Лазаренко
Lazarenko	ラザレンコ	Лазаренко
Lazarenko	ラザレンコ
Лазуткин
Lazutkin	ラズトキン	Лазуткина
Lazutkina	ラズトキナ
Лапин
Lapin	ラーピン	Лапина
Lapina	ラーピナ
Лаптев
Laptev	ラプチェフ	Лаптева
Lapteva	ラプチェヴァ
Лапшин
Lapshin	ラプシン	Лапшина
Lapshina	ラプシナ
Ларионов
Larionov	ラリオノフ	Ларионова
Larionova	ラリオノヴァ
Латкин
Latkin	ラトキン	Латкина
Latkina	ラトキナ
Латышев
Latyshev	ラートィシェフ	Латышева
Latysheva	ラートィシェヴァ
Лебедев
Lebedev	レベジェフ	Лебедева
Lebedeva	レベジェヴァ
Левашов
Levashov	レヴァショフ	Левашова
Levashova	レヴァショヴァ
Леведев
Levedev	レヴェジェフ	Леведева
Levedeva	レヴェジェヴァ
Левитан
Levitan	レヴィタン	Левитана
Levitana	レヴィタナ
Левков
Levkov	レフコフ	Левкова
Levkova	レフコヴァ
Левченко
Levchenko	レフチェンコ	Левченко
Levchenko	レフチェンコ
Легков
Legkov	レクコフ	Легкова
Legkova	レクコヴァ
Леднев
Lednev	レドネフ	Леднева
Ledneva	レドネヴァ
Лежнин
Lezhnin	レズニン	Лежнина
Lezhnina	レズニナ
Лемешев
Lemeshev	レメシェフ	Лемешева
Lemesheva	レメシェヴァ
Лемешов
Lemeshov	レメショフ	Лемешова
Lemeshova	レメショヴァ
Леонов
Leonov	レオーノフ、レオノフ	Леонова
Leonova	レオーノヴァ、レオノヴァ
Леонтьев
Leontev	レオーンチェフ	Леонтьева
Leonteva	レオーンチェヴァ
Леончев
Leonchev	レオンチェフ	Леончева
Leoncheva	レオンチェヴァ
Лепёхин
Lepyokhin	レピョーヒン	Лепёхина
Lepyokhina	レピョーヒナ
Лескин
Leskin	レスキン	Лескина
Leskina	レスキナ
Лесков
Leskov	レスコフ	Лескова
Leskova	レスコヴァ
Леушкин
Leushkin	レウシュキン	Леушкина
Leushkina	レウシュキナ
Ливанов
Livanov	リヴァノフ	Ливанова
Livanova	リヴァノヴァ
Ливинский
Livinsky	リヴィンスキー	Ливинская
Livinskaya	リヴィンスカヤ
Лигачёв
Ligachyov	リガチョフ	Лигачёва
Ligachyova	リガチョヴァ
Лиманский
Limansky	リマンスキー	Лиманская
Limanskaya	リマンスカヤ
Липницкий
Lipnitsky	リプニツキー	Липницкая
Lipnitskaya	リプニツカヤ
Лисин
Lisin	リーシン	Лисина
Lisina	リーシナ
Лисицын
Lisitsyn	リシツィン	Лисицына
Lisitsyna	リシツィナ
Лисичкин
Lisichkin	リシチキン	Лисичкина
Lisichkina	リシチキナ
Литвиненко
Litvinenko	リトヴィネンコ	Литвиненко
Litvinenko	リトヴィネンコ
Литвинов
Litvinov	リトヴィノフ	Литвинова
Litvinova	リトヴィノヴァ
Литвинцев
Litvintsev	リトヴィンツェフ	Литвинцева
Litvintseva	リトヴィンツェヴァ
Лифоров
Liforov	リフォロフ	Лифорова
Liforova	リフォロヴァ
Лихачёв
Likhachyov	リハチョフ	Лихачёва
Likhachyova	リハチョヴァ
Личенко
Lichenko	リチェンコ	Личенко
Lichenko	リチェンコ
Лобанов
Lobanov	ロバーノフ	Лобанова
Lobanova	ロバーノヴァ
Лобков
Lobkov	ロプコフ	Лобкова
Lobkova	ロプコヴァ
Лобов
Lobov	ローボフ	Лобова
Lobova	ローボヴァ
Лобухин
Lobukhin	ロブーヒン	Лобухина
Lobukhina	ロブーヒナ
Лобышев
Lobyshev	ロブィシェフ	Лобышева
Lobysheva	ロブィシェヴァ
Логинов
Loginov	ロギノフ	Логинова
Loginova	ロギノヴァ
Логуненко
Logunenko	ログネンコ	Логуненко
Logunenko	ログネンコ
Логунов
Logunov	ログノフ	Логунова
Logunova	ログノヴァ
Лодкин
Lodkin	ロトキン	Лодкина
Lodkina	ロトキナ
Лозов
Lozov	ローゾフ	Лозова
Lozova	ローゾヴァ
Локтионов
Loktionov	ロクチオノフ	Локтионова
Loktionova	ロクチオノヴァ
Ломакин
Lomakin	ロマキン	Ломакина
Lomakina	ロマキナ
Лопатикин
Lopatikin	ロパチキン	Лопатикина
Lopatikina	ロパチキナ
Лопатин
Lopatin	ロパーチン	Лопатина
Lopatina	ロパーチナ
Лопаткин
Lopatkin	ロパートキン	Лопаткина
Lopatkina	ロパートキナ
Лопухов
Lopukhov	ロプホフ	Лопухова
Lopukhova	ロプホヴァ
Лосев
Losev	ローセフ	Лосева
Loseva	ローセヴァ
Лотков
Lotkov	ロトコフ	Лоткова
Lotkova	ロトコヴァ
Лубенченко
Lubenchenko	ルベンチェンコ	Лубенченко
Lubenchenko	ルベンチェンコ
Лужков
Luzhkov	ルシュコフ	Лужкова
Luzhkova	ルシュコヴァ
Лукашёв
Lukashyov	ルカショフ	Лукашёва
Lukashyova	ルカショヴァ
Лукин
Lukin	ルキーン	Лукина
Lukina	ルキーナ
Лукьянов
Lukyanov	ルキヤノフ	Лукьянова
Lukyanova	ルキヤノヴァ
Лунёв
Lunyov	ルニョフ	Лунёва
Lunyova	ルニョヴァ
Лунтовский
Luntovsky	ルントフスキー	Лунтовская
Luntovskaya	ルントフスカヤ
Лучагин
Luchagin	ルチャギン	Лучагина
Luchagina	ルチャギナ
Лыжин
Lyzhin	ルィジン	Лыжина
Lyzhina	ルィジナ
Лысенко
Lysenko	ルィセンコ	Лысенко
Lysenko	ルィセンコ
Лысов
Lysov	ルィソフ	Лысова
Lysova	ルィソヴァ
Лыткин
Lytkin	ルィートキン	Лыткина
Lytkina	ルィートキナ
Любимов
Lyubimov	リュビーモフ	Любимова
Lyubimova	リュビーモヴァ
Люблин
Lyublin	リュブリン	Люблина
Lyublina	リュブリナ
Лютов
Lyutov	リュトフ	Лютова
Lyutova	リュトヴァ
Ляхов
Lyakhov	リャホフ	Ляхова
Lyakhova	リャホヴァ
Лящевский
Lyashchevsky	リャシェフスキー、リャシチェフスキー	Лящевская
Lyashchevskaya	リャシェフスカヤ、リャシチェフスカヤ
Магин
Magin	マギン	Магина
Magina	マギナ
Магомедов
Magomedov	マゴメドフ	Магомедова
Magomedova	マゴメドヴァ
Мазаев
Mazayev	マザエフ	Мазаева
Mazayeva	マザエヴァ
Майоров
Mayorov	マイヨーロフ	Майорова
Mayorova	マイヨーロヴァ
Майтаков
Maytakov	マイタコフ	Майтакова
Maytakova	マイタコヴァ
Макагонов
Makagonov	マカゴノフ	Макагонова
Makagonova	マカゴノヴァ
Макаренко
Makarenko	マカレンコ	Макаренко
Makarenko	マカレンコ
Макаренцев
Makarentsev	マカレンツェフ	Макаренцева
Makarentseva	マカレンツェヴァ
Макаров
Makarov	マカロフ	Макарова
Makarova	マカロヴァ
Макашов
Makashov	マカショフ	Макашова
Makashova	マカショヴァ
Маковеев
Makoveyev	マコヴェエフ	Маковеева
Makoveyeva	マコヴェエヴァ
Максаков
Maksakov	マクサコフ	Максакова
Maksakova	マクサコヴァ
Максименко
Maksimenko	マクシメンコ	Максименко
Maksimenko	マクシメンコ
Максимов
Maksimov	マクシモフ	Максимова
Maksimova	マクシモヴァ
Максимцев
Maksimtsev	マクシムツェフ	Максимцева
Maksimtseva	マクシムツェヴァ
Малеев
Maleyev	マレーエフ	Малеева
Maleyeva	マレーエヴァ
Малкин
Malkin	マルキン	Малкина
Malkina	マルキナ
Малов
Malov	マロフ	Малова
Malova	マロヴァ
Малыхин
Malykhin	マルィヒン	Малыхина
Malykhina	マルィヒナ
Малышев
Malyshev	マルィシェフ	Малышева
Malysheva	マルィシェヴァ
Мальков
Malkov	マリコフ	Малькова
Malkova	マリコヴァ
Мальцев
Maltsev	マリツェフ	Мальцева
Maltseva	マリツェヴァ
Мамедов
Mamedov	マメドフ	Мамедова
Mamedova	マメドヴァ
Мамлеев
Mamleyev	マムレーエフ	Мамлеева
Mamleyeva	マムレーエヴァ
Мамонтов
Mamontov	マーモントフ	Мамонтова
Mamontova	マーモントヴァ
Манаенков
Manayenkov	マナエンコフ	Манаенкова
Manayenkova	マナエンコヴァ
Мананников
Manannikov	マナンニコフ	Мананникова
Manannikova	マナンニコヴァ
Мандрыгин
Mandrygin	マンドルィギン	Мандрыгина
Mandrygina	マンドルィギナ
Манежев
Manezhev	マネジェフ	Манежева
Manezheva	マネジェヴァ
Манжосов
Manzhosov	マンジョソフ	Манжосова
Manzhosova	マンジョソヴァ
Манилов
Manilov	マニロフ	Манилова
Manilova	マニロヴァ
Манохин
Manokhin	マノヒン	Манохина
Manokhina	マノヒナ
Маношкин
Manoshkin	マノシュキン	Маношкина
Manoshkina	マノシュキナ
Манякин
Manyakin	マニャーキン	Манякина
Manyakina	マニャーキナ
Маркелов
Markelov	マルケロフ	Маркелова
Markelova	マルケロヴァ
Маркидонов
Markidonov	マルキドノフ	Маркидонова
Markidonova	マルキドノヴァ
Марков
Markov	マルコフ	Маркова
Markova	マルコヴァ
Марковский
Markovsky	マルコフスキー	Марковская
Markovskaya	マルコフスカヤ
Маркоменко
Markomenko	マルコメンコ	Маркоменко
Markomenko	マルコメンコ
Мартемьянов
Martemyanov	マルチェミヤーノフ	Мартемьянова
Martemyanova	マルチェミヤーノヴァ
Мартыненко
Martynenko	マルトィネンコ	Мартыненко
Martynenko	マルトィネンコ
Мартынов
Martynov	マルトィノフ	Мартынова
Martynova	マルトィノヴァ
Мартьянов
Martyanov	マルチヤノフ	Мартьянова
Martyanova	マルチヤノヴァ
Марченко
Marchenko	マルチェンコ	Марченко
Marchenko	マルチェンコ
Маршев
Marshev	マルシェフ	Маршева
Marsheva	マルシェヴァ
Марычев
Marychev	マルィチェフ	Марычева
Marycheva	マルィチェヴァ
Маскаев
Maskayev	マスカエフ	Маскаева
Maskayeva	マスカエヴァ
Маслов
Maslov	マスロフ	Маслова
Maslova	マスロヴァ
Масловский
Maslovsky	マスロフスキー	Масловская
Maslovskaya	マスロフスカヤ
Маслюков
Maslyukov	マスリュコフ	Маслюкова
Maslyukova	マスリュコヴァ
Мастафов
Mastafov	マスタフォフ	Мастафова
Mastafova	マスタフォヴァ
Матвеев
Matveyev	マトヴェーエフ	Матвеева
Matveyeva	マトヴェーエヴァ
Матвиенко
Matviyenko	マトヴィエンコ	Матвиенко
Matviyenko	マトヴィエンコ
Матеров
Materov	マチェロフ	Матерова
Materova	マチェロヴァ
Маточкин
Matochkin	マトチキン	Маточкина
Matochkina	マトチキナ
Матюнин
Matyunin	マチュニン	Матюнина
Matyunina	マチュニナ
Матюхин
Matyukhin	マチュヒン	Матюхина
Matyukhina	マチュヒナ
Матюшов
Matyushov	マチュショフ	Матюшова
Matyushova	マチュショヴァ
Матяшов
Matyashov	マチャショフ	Матяшова
Matyashova	マチャショヴァ
Махалин
Makhalin	マハーリン	Махалина
Makhalina	マハーリナ
Маханов
Makhanov	マハノフ	Маханова
Makhanova	マハノヴァ
Машевский
Mashevsky	マシェフスキー	Машевская
Mashevskaya	マシェフスカヤ
Машинский
Mashinsky	マシンスキー	Машинская
Mashinskaya	マシンスカヤ
Машков
Mashkov	マシュコフ、マシュコーフ	Машкова
Mashkova	マシュコヴァ、マシュコーヴァ
Машковцев
Mashkovtsev	マシュコーフツェフ	Машковцева
Mashkovtseva	マシュコーフツェヴァ
Медведев
Medvedev	メドヴェージェフ（メドベージェフ）	Медведева
Medvedeva	メドヴェージェヴァ
Меденцов
Medentsov	メジェンツォフ	Меденцова
Medentsova	メジェンツォヴァ
Медиков
Medikov	メジコフ	Медикова
Medikova	メジコヴァ
Мезенцев
Mezentsev	メゼンツェフ	Мезенцева
Mezentseva	メゼンツェヴァ
Мелентьев
Melentev	メレンチェフ	Мелентьева
Melenteva	メレンチェヴァ
Мелех
Melekh	メレフ	Мелех
Melekh	メレフ
Меликьян
Melikyan	メリキヤン	Меликьяна
Melikyana	メリキヤナ
Мельков
Melkov	メリコフ	Мелькова
Melkova	メリコヴァ
Мельников
Melnikov	メリニコフ	Мельникова
Melnikova	メリニコヴァ
Мельниченко
Melnichenko	メリニチェンコ	Мельниченко
Melnichenko	メリニチェンコ
Меньшиков
Menshikov	メニシコフ	Меньшикова
Menshikova	メニシコヴァ
Меньшов
Menshov	メニショフ	Меньшова
Menshova	メニショヴァ
Меньщиков
Menshchikov	メーニシコフ、メーニシチコフ	Меньщикова
Menshchikova	メーニシコヴァ、メーニシチコヴァ
Меремянин
Meremyanin	メレミャーニン	Меремянина
Meremyanina	メレミャーニナ
Меркулов
Merkulov	メルクロフ	Меркулова
Merkulova	メルクロヴァ
Меркушев
Merkushev	メルクシェフ	Меркушева
Merkusheva	メルクシェヴァ
Меркушин
Merkushin	メルクーシン	Меркушина
Merkushina	メルクーシナ
Мерцалов
Mertsalov	メルツァロフ	Мерцалова
Mertsalova	メルツァロヴァ
Меськов
Meskov	メシコフ	Меськова
Meskova	メシコヴァ
Метелев
Metelev	メチェレフ	Метелева
Meteleva	メチェレヴァ
Мешалкин
Meshalkin	メシャルキン	Мешалкина
Meshalkina	メシャルキナ
Мещеряков
Meshcheryakov	メシェリャコフ、メシチェリャコフ	Мещерякова
Meshcheryakova	メシェリャコヴァ、メシチェリャコヴァ
Мигранян
Migranyan	ミグラニャン	Миграняна
Migranyana	ミグラニャナ
Мигунов
Migunov	ミグノフ	Мигунова
Migunova	ミグノヴァ
Миклин
Miklin	ミクリン	Миклина
Miklina	ミクリナ
Микоян
Mikoyan	ミコヤン	Микояна
Mikoyana	ミコヤナ
Милов
Milov	ミロフ	Милова
Milova	ミロヴァ
Минаков
Minakov	ミナコフ	Минакова
Minakova	ミナコヴァ
Мироненко
Mironenko	ミロネンコ	Мироненко
Mironenko	ミロネンコ
Миронов
Mironov	ミロノフ	Миронова
Mironova	ミロノヴァ
Миськов
Miskov	ミシコフ	Миськова
Miskova	ミシコヴァ
Митин
Mitin	ミーチン	Митина
Mitina	ミーチナ
Митрофанов
Mitrofanov	ミトロファノフ	Митрофанова
Mitrofanova	ミトロファノヴァ
Митрохин
Mitrokhin	ミトロヒン	Митрохина
Mitrokhina	ミトロヒナ
Митюков
Mityukov	ミチュコフ	Митюкова
Mityukova	ミチュコヴァ
Митяев
Mityayev	ミチャーエフ	Митяева
Mityayeva	ミチャーエヴァ
Михайлов
Mikhaylov	ミハイロフ	Михайлова
Mikhaylova	ミハイロヴァ
Михалёв
Mikhalyov	ミハリョフ	Михалёва
Mikhalyova	ミハリョヴァ
Михалков
Mikhalkov	ミハルコフ	Михалкова
Mikhalkova	ミハルコヴァ
Михеев
Mikheyev	ミヘーエフ	Михеева
Mikheyeva	ミヘーエヴァ
Мишин
Mishin	ミーシン	Мишина
Mishina	ミーシナ
Мищенков
Mishchenkov	ミシェンコフ、ミシチェンコフ	Мищенкова
Mishchenkova	ミシェンコヴァ、ミシチェンコヴァ
Моднов
Modnov	モドノフ	Моднова
Modnova	モドノヴァ
Моисеев
Moiseyev	モイセーエフ	Моисеева
Moiseyeva	モイセーエヴァ
Моисеенко
Moiseyenko	モイセーエンコ	Моисеенко
Moiseyenko	モイセーエンコ
Мокроусов
Mokrousov	モクロウソフ	Мокроусова
Mokrousova	モクロウソヴァ
Молоствов
Molostvov	モロストヴォフ	Молоствова
Molostvova	モロストヴォヴァ
Молотков
Molotkov	モロトコフ	Молоткова
Molotkova	モロトコヴァ
Молотов
Molotov	モロトフ	Молотова
Molotova	モロトヴァ
Молочков
Molochkov	モロチコフ	Молочкова
Molochkova	モロチコヴァ
Молчанов
Molchanov	モルチャノフ	Молчанова
Molchanova	モルチャノヴァ
Моляренко
Molyarenko	モリャレンコ	Моляренко
Molyarenko	モリャレンコ
Монастырский
Monastyrsky	モナストィルスキー	Монастырская
Monastyrskaya	モナストィルスカヤ
Монисов
Monisov	モニソフ	Монисова
Monisova	モニソヴァ
Моргун
Morgun	モルグン	Моргуна
Morguna	モルグナ
Морозов
Morozov	モロゾフ	Морозова
Morozova	モロゾヴァ
Морокин
Morokin	モロキン	Морокина
Morokina	モロキナ
Москвичёв
Moskvichyov	モスクヴィチョフ	Москвичёва
Moskvichyova	モスクヴィチョヴァ
Московский
Moskovsky	モスコフスキー	Московская
Moskovskaya	モスコフスカヤ
Мостовой
Mostovoy	モストヴォイ	Мостовая
Mostovaya	モストヴァヤ
Мошенко
Moshenko	モシェンコ	Мошенко
Moshenko	モシェンコ
Мошкин
Moshkin	モーシュキン	Мошкина
Moshkina	モーシュキナ
Мощенков
Moshchenkov	モシェンコフ、モシチェンコフ	Мощенкова
Moshchenkova	モシェンコヴァ、モシチェンコヴァ
Музыкантский
Muzykantsky	ムズィカンツキー	Музыкантская
Muzykantskaya	ムズィカンツカヤ
Мукусев
Mukusev	ムクセフ	Мукусева
Mukuseva	ムクセヴァ
Муравьёв
Muravyov	ムラヴィヨフ	Муравьёва
Muravyova	ムラヴィヨヴァ
Муранов
Muranov	ムラノフ	Муранова
Muranova	ムラノヴァ
Муратов
Muratov	ムラトフ	Муратова
Muratova	ムラトヴァ
Мурашев
Murashev	ムラシェフ	Мурашева
Murasheva	ムラシェヴァ
Мусатов
Musatov	ムサトフ	Мусатова
Musatova	ムサトヴァ
Мутков
Mutkov	ムトコフ	Муткова
Mutkova	ムトコヴァ
Мухаметшин
Mukhametshin	ムハメトシン	Мухаметшина
Mukhametshina	ムハメトシナ
Мухин
Mukhin	ムーヒン	Мухина
Mukhina	ムーヒナ
Мытаков
Mytakov	ムイタコフ	Мытакова
Mytakova	ムイタコヴァ
Мясников
Myasnikov	ミャスニコーフ	Мясникова
Myasnikova	ミャスニコーヴァ
Набоков
Nabokov	ナボコフ	Набокова
Nabokova	ナボコヴァ
Нажейн
Nazheyn	ナジェイン	Нажейна
Nazheyna	ナジェイナ
Назаренко
Nazarenko	ナザレンコ	Назаренко
Nazarenko	ナザレンコ
Назаров
Nazarov	ナザロフ	Назарова
Nazarova	ナザロヴァ
Наздратенко
Nazdratenko	ナズドラチェンコ	Наздратенко
Nazdratenko	ナズドラチェンコ
Наполов
Napolov	ナポロフ	Наполова
Napolova	ナポロヴァ
Наролин
Narolin	ナロリン	Наролина
Narolina	ナロリナ
Насиновский
Nasinovsky	ナシノフスキー	Насиновская
Nasinovskaya	ナシノフスカヤ
Наталенко
Natalenko	ナタレンコ	Наталенко
Natalenko	ナタレンコ
Натапов
Natapov	ナタポフ	Натапова
Natapova	ナタポヴァ
Наумов
Naumov	ナウモフ	Наумова
Naumova	ナウモヴァ
Невзоров
Nevzorov	ネヴゾロフ	Невзорова
Nevzorova	ネヴゾロヴァ
Неделин
Nedelin	ネジェーリン	Неделина
Nedelina	ネジェーリナ
Неёлов
Neyolov	ネヨーロフ	Неёлова
Neyolova	ネヨーロヴァ
Некрасов
Nekrasov	ネクラーソフ	Некрасова
Nekrasova	ネクラーソヴァ
Некрутенко
Nekrutenko	ネクルチェンコ	Некрутенко
Nekrutenko	ネクルチェンコ
Неласов
Nelasov	ネラソフ	Неласова
Nelasova	ネラソヴァ
Немцов
Nemtsov	ネムツォフ	Немцова
Nemtsova	ネムツォヴァ
Нескоблинов
Neskoblinov	ネスコブリノフ	Нескоблинова
Neskoblinova	ネスコブリノヴァ
Нестеренко
Nesterenko	ネスチェレンコ、ネステレンコ	Нестеренко
Nesterenko	ネスチェレンコ、ネステレンコ
Нестеров
Nesterov	ネスチェロフ、ネステロフ	Нестерова
Nesterova	ネスチェロヴァ、ネステロヴァ
Неуймин
Neuymin	ネウイミン	Неуймина
Neuymina	ネウイミナ
Нечаев
Nechayev	ネチャエフ	Нечаева
Nechayeva	ネチャエヴァ
Нижинский
Nizhinsky	ニジンスキー	Нижинская
Nizhinskaya	ニジンスカヤ
Никандров
Nikandrov	ニカンドロフ	Никандрова
Nikandrova	ニカンドロヴァ
Никаноров
Nikanorov	ニカノロフ	Никанорова
Nikanorova	ニカノロヴァ
Никитенко
Nikitenko	ニキーチェンコ	Никитенко
Nikitenko	ニキーチェンコ
Никитин
Nikitin	ニキーチン	Никитина
Nikitina	ニキーチナ
Никитов
Nikitov	ニキートフ	Никитова
Nikitova	ニキートヴァ
Никифоренко
Nikiforenko	ニキフォレンコ	Никифоренко
Nikiforenko	ニキフォレンコ
Никифоров
Nikiforov	ニキフォロフ	Никифорова
Nikiforova	ニキフォロヴァ
Николаев
Nikolayev	ニコラエフ	Николаева
Nikolayeva	ニコラエヴァ
Никологорский
Nikologorsky	ニコロゴルスキー	Никологорская
Nikologorskaya	ニコロゴルスカヤ
Никольский
Nikolsky	ニコリスキー	Никольская
Nikolskaya	ニコリスカヤ
Никонов
Nikonov	ニコノフ	Никонова
Nikonova	ニコノヴァ
Никотин
Nikotin	ニコチン	Никотина
Nikotina	ニコチナ
Никуленко
Nikulenko	ニクレンコ	Никуленко
Nikulenko	ニクレンコ
Никулин
Nikulin	ニクーリン	Никулина
Nikulina	ニクーリナ
Нимаев
Nimayev	ニマエフ	Нимаева
Nimayeva	ニマエヴァ
Новиков
Novikov	ノヴィコフ	Новикова
Novikova	ノヴィコヴァ
Новоселов
Novoselov	ノヴォセロフ	Новоселова
Novoselova	ノヴォセロヴァ
Новосельцов
Novoseltsov	ノヴォセリツォフ	Новосельцова
Novoseltsova	ノヴォセリツォヴァ
Ножиков
Nozhikov	ノジコフ	Ножикова
Nozhikova	ノジコヴァ
Носков
Noskov	ノスコーフ	Носкова
Noskova	ノスコーヴァ
Носов
Nosov	ノーソフ	Носова
Nosova	ノーソヴァ
Нуйкин
Nuykin	ヌイキン	Нуйкина
Nuykina	ヌイキナ
Нуреев
Nureyev	ヌレーエフ	Нуреева
Nureyeva	ヌレーエヴァ
Обласов
Oblasov	オブラソフ	Обласова
Oblasova	オブラソヴァ
Обухов
Obukhov	オブホフ	Обухова
Obukhova	オブホヴァ
Овсянников
Ovsyannikov	オフシャーンニコフ	Овсянникова
Ovsyannikova	オフシャーンニコヴァ
Овчаров
Ovcharov	オフチャロフ	Овчарова
Ovcharova	オフチャロヴァ
Овченков
Ovchenkov	オフチェンコフ	Овченкова
Ovchenkova	オフチェンコヴァ
Овчинников
Ovchinnikov	オフチーンニコフ	Овчинникова
Ovchinnikova	オフチーンニコヴァ
Огородников
Ogorodnikov	オゴロドニコフ	Огородникова
Ogorodnikova	オゴロドニコヴァ
Огурцов
Ogurtsov	オグルツォフ	Огурцова
Ogurtsova	オグルツォヴァ
Одинцов
Odintsov	オジンツォフ	Одинцова
Odintsova	オジンツォヴァ
Озеров
Ozerov	オゼロフ	Озерова
Ozerova	オゼロヴァ
Окатов
Okatov	オカトフ	Окатова
Okatova	オカトヴァ
Ольховиков
Olkhovikov	オリホヴィコフ	Ольховикова
Olkhovikova	オリホヴィコヴァ
Онищенко
Onishchenko	オニーシェンコ、オニーシチェンコ	Онищенко
Onishchenko	オニーシェンコ、オニーシチェンコ
Оноприенко
Onopriyenko	オノプリエンコ	Оноприенко
Onopriyenko	オノプリエンコ
Опенышев
Openyshev	オペヌィシェフ	Опенышева
Openysheva	オペヌィシェヴァ
Орехов
Orekhov	オレーホフ	Орехова
Orekhova	オレーホヴァ
Орлов
Orlov	オルロフ	Орлова
Orlova	オルロヴァ
Орловский
Orlovsky	オルロフスキー	Орловская
Orlovskaya	オルロフスカヤ
Осадчих
Osadchikh	オサトチフ	Осадчих
Osadchikh	オサトチフ
Осипенко
Osipenko	オシペンコ	Осипенко
Osipenko	オシペンコ
Осипов
Osipov	オシポフ	Осипова
Osipova	オシポヴァ
Осминин
Osminin	オスミニン	Осминина
Osminina	オスミニナ
Осмолкин
Osmolkin	オスモルキン	Осмолкина
Osmolkina	オスモルキナ
Осовцов
Osovtsov	オソフツォフ	Осовцова
Osovtsova	オソフツォヴァ
Островский
Ostrovsky	オストロフスキー	Островская
Ostrovskaya	オストロフスカヤ
Остроумов
Ostroumov	オストロウモフ	Остроумова
Ostroumova	オストロウモヴァ
Павленко
Pavlenko	パヴレンコ	Павленко
Pavlenko	パヴレンコ
Павличенко
Pavlichenko	パヴリチェンコ	Павличенко
Pavlichenko	パヴリチェンコ
Павлов
Pavlov	パヴロフ	Павлова
Pavlova	パヴロヴァ
Павлухин
Pavlukhin	パヴルヒン	Павлухина
Pavlukhina	パヴルヒナ
Палеев
Paleyev	パレーエフ	Палеева
Paleyeva	パレーエヴァ
Панарин
Panarin	パナーリン	Панарина
Panarina	パナーリナ
Панкин
Pankin	パンキン、パーンキン	Панкина
Pankina	パンキナ、パーンキナ
Панкратенко
Pankratenko	パンクラチェンコ	Панкратенко
Pankratenko	パンクラチェンコ
Панов
Panov	パノーフ、パノフ	Панова
Panova	パノーヴァ、パノヴァ
Пансков
Panskov	パンスコフ	Панскова
Panskova	パンスコヴァ
Панфёров
Panfyorov	パンフョーロフ	Панфёрова
Panfyorova	パンフョーロヴァ
Панфилов
Panfilov	パンフィロフ	Панфилова
Panfilova	パンフィロヴァ
Панькин
Pankin	パニキン	Панькина
Pankina	パニキナ
Парамонов
Paramonov	パラモノフ	Парамонова
Paramonova	パラモノヴァ
Парин
Parin	パーリン	Парина
Parina	パーリナ
Паринов
Parinov	パリノフ	Паринова
Parinova	パリノヴァ
Парфёнов
Parfyonov	パルフョーノフ	Парфёнова
Parfyonova	パルフョーノヴァ
Пархоменко
Parkhomenko	パルホメンコ	Пархоменко
Parkhomenko	パルホメンコ
Паршаков
Parshakov	パルシャコフ	Паршакова
Parshakova	パルシャコヴァ
Пастухов
Pastukhov	パストゥホフ	Пастухова
Pastukhova	パストゥホヴァ
Патанов
Patanov	パタノフ	Патанова
Patanova	パタノヴァ
Патрушев
Patrushev	パトルシェフ	Патрушева
Patrusheva	パトルシェヴァ
Пахомов
Pakhomov	パホモフ	Пахомова
Pakhomova	パホモヴァ
Пашин
Pashin	パーシン	Пашина
Pashina	パーシナ
Пашков
Pashkov	パシュコフ	Пашкова
Pashkova	パシュコヴァ
Пащенко
Pashchenko	パーシェンコ、パーシチェンコ	Пащенко
Pashchenko	パーシェンコ、パーシチェンコ
Пеганов
Peganov	ペガノフ	Пеганова
Peganova	ペガノヴァ
Пекарский
Pekarsky	ペカルスキー	Пекарская
Pekarskaya	ペカルスカヤ
Пелевин
Pelevin	ペレーヴィン	Пелевина
Pelevina	ペレーヴィナ
Пестов
Pestov	ペーストフ	Пестова
Pestova	ペーストヴァ
Петошин
Petoshin	ペトシン	Петошина
Petoshina	ペトシナ
Петраков
Petrakov	ペトラコフ	Петракова
Petrakova	ペトラコヴァ
Петренко
Petrenko	ペトレンコ	Петренко
Petrenko	ペトレンコ
Петрищев
Petrishchev	ペトリーシェフ、ペトリーシチェフ	Петрищева
Petrishcheva	ペトリーシェヴァ、ペトリーシチェヴァ
Петров
Petrov	ペトロフ	Петрова
Petrova	ペトロヴァ
Петровский
Petrovsky	ペトロフスキー	Петровская
Petrovskaya	ペトロフスカヤ
Петрушкин
Petrushkin	ペトルーシュキン	Петрушкина
Petrushkina	ペトルーシュキナ
Петухов
Petukhov	ペトゥホーフ	Петухова
Petukhova	ペトゥホーヴァ
Печенкин
Pechenkin	ペチェンキン	Печенкина
Pechenkina	ペチェンキナ
Пешков
Peshkov	ペシュコフ	Пешкова
Peshkova	ペシュコヴァ
Пивоваров
Pivovarov	ピヴォヴァロフ	Пивоварова
Pivovarova	ピヴォヴァロヴァ
Пименов
Pimenov	ピーメノフ、ピメノフ	Пименова
Pimenova	ピーメノヴァ、ピメノヴァ
Пирогов
Pirogov	ピロゴフ	Пирогова
Pirogova	ピロゴヴァ
Писаренко
Pisarenko	ピサレンコ	Писаренко
Pisarenko	ピサレンコ
Пискнов
Pisknov	ピスクノフ	Пискнова
Pisknova	ピスクノヴァ
Пискун
Piskun	ピスクン、ピスクーン	Пискун
Piskun	ピスクン、ピスクーン
Платов
Platov	プラートフ、プラトフ	Платова
Platova	プラートヴァ、プラトヴァ
Платонов
Platonov	プラトーノフ	Платонова
Platonova	プラトーノヴァ
Плетнёв
Pletnyov	プレトニョフ	Плетнёва
Pletnyova	プレトニョヴァ
Плотников
Plotnikov	プロトニコフ	Плотникова
Plotnikova	プロトニコヴァ
Плющенко
Plyushchenko	プリューシェンコ、プリューシチェンコ（プルシェンコ）	Плющенко
Plyushchenko	プリューシェンコ、プリューシチェンコ
Подберёзкин
Podberyozkin	ポドベリョスキン	Подберёзкина
Podberyozkina	ポドベリョスキナ
Подгорнов
Podgornov	ポドゴルノフ	Подгорнова
Podgornova	ポドゴルノヴァ
Подуфалов
Podufalov	ポドゥファロフ	Подуфалова
Podufalova	ポドゥファロヴァ
Подчуфаров
Podchufarov	ポトチュファロフ	Подчуфарова
Podchufarova	ポトチュファロヴァ
Пожитков
Pozhitkov	ポジトコフ	Пожиткова
Pozhitkova	ポジトコヴァ
Позгалёв
Pozgalyov	ポズガーリョフ	Позгалёва
Pozgalyova	ポズガーリョヴァ
Поздняков
Pozdnyakov	ポズニャコフ	Позднякова
Pozdnyakova	ポズニャコヴァ
Покровский
Pokrovsky	ポクロフスキー	Покровская
Pokrovskaya	ポクロフスカヤ
Полдников
Poldnikov	ポルドニコフ	Полдникова
Poldnikova	ポルドニコヴァ
Полеванов
Polevanov	ポレヴァノフ	Полеванова
Polevanova	ポレヴァノヴァ
Полежаев
Polezhayev	ポレジャエフ	Полежаева
Polezhayeva	ポレジャエヴァ
Поливанов
Polivanov	ポリヴァノフ	Поливанова
Polivanova	ポリヴァノヴァ
Политковский
Politkovsky	ポリトコフスキー	Политковская
Politkovskaya	ポリトコフスカヤ
Полозков
Polozkov	ポロスコフ	Полозкова
Polozkova	ポロスコヴァ
Полонский
Polonsky	ポロンスキー	Полонская
Polonskaya	ポロンスカヤ
Полосин
Polosin	ポローシン	Полосина
Polosina	ポローシナ
Полтавцев
Poltavtsev	ポルタフツェフ	Полтавцева
Poltavtseva	ポルタフツェヴァ
Полторанин
Poltoranin	ポルトラーニン	Полторанина
Poltoranina	ポルトラーニナ
Полунин
Polunin	ポルーニン	Полунина
Polunina	ポルーニナ
Полупанов
Polupanov	ポルパノフ	Полупанова
Polupanova	ポルパノヴァ
Полуянов
Poluyanov	ポルヤノフ	Полуянова
Poluyanova	ポルヤノヴァ
Поляков
Polyakov	ポリャコフ	Полякова
Polyakova	ポリャコヴァ
Поморов
Pomorov	ポモーロフ	Поморова
Pomorova	ポモーロヴァ
Понамаренко
Ponamarenko	ポナマレンコ	Понамаренко
Ponamarenko	ポナマレンコ
Понасов
Ponasov	ポナソフ	Понасова
Ponasova	ポナソヴァ
Пономарёв
Ponomaryov	ポノマリョフ	Пономарёва
Ponomaryova	ポノマリョヴァ
Пономаренко
Ponomarenko	ポノマレンコ	Пономаренко
Ponomarenko	ポノマレンコ
Попов
Popov	ポポーフ、ポポフ	Попова
Popova	ポポーヴァ、ポポヴァ
Портнов
Portnov	ポルトノフ	Портнова
Portnova	ポルトノヴァ
Порядин
Poryadin	ポリャジン	Порядина
Poryadina	ポリャジナ
Потанин
Potanin	ポターニン	Потанина
Potanina	ポターニナ
Потапенко
Potapenko	ポタペンコ	Потапенко
Potapenko	ポタペンコ
Потапов
Potapov	ポターポフ、ポタポフ	Потапова
Potapova	ポターポヴァ、ポタポヴァ
Потёмкин
Potyomkin	ポチョムキン	Потёмкина
Potyomkina	ポチョムキナ
Потолицын
Potolitsyn	ポトリツィン	Потолицына
Potolitsyna	ポトリツィナ
Похмелкин
Pokhmelkin	ポフメルキン	Похмелкина
Pokhmelkina	ポフメルキナ
Почеревин
Pocherevin	ポチェレヴィン	Почеревина
Pocherevina	ポチェレヴィナ
Преображенский
Preobrazhensky	プレオブラジェンスキー	Преображенская
Preobrazhenskaya	プレオブラジェンスカヤ
Пржездомский
Przhezdomsky	プルジェズドムスキー	Пржездомская
Przhezdomskaya	プルジェズドムスカヤ
Примаков
Primakov	プリマコフ	Примакова
Primakova	プリマコヴァ
Приставкин
Pristavkin	プリスタフキン	Приставкина
Pristavkina	プリスタフキナ
Прокопенко
Prokopenko	プロコペンコ	Прокопенко
Prokopenko	プロコペンコ
Прокопьев
Prokopev	プロコピエフ	Прокопьева
Prokopeva	プロコピエヴァ
Прокудин
Prokudin	プロクージン	Прокудина
Prokudina	プロクージナ
Пронин
Pronin	プローニン	Пронина
Pronina	プローニナ
Просвирнов
Prosvirnov	プロスヴィルノフ	Просвирнова
Prosvirnova	プロスヴィルノヴァ
Проскуряков
Proskuryakov	プロスクリャコフ	Проскурякова
Proskuryakova	プロスクリャコヴァ
Проткопов
Protkopov	プロトコポフ	Проткопова
Protkopova	プロトコポヴァ
Прохоров
Prokhorov	プロホロフ	Прохорова
Prokhorova	プロホロヴァ
Проценко
Protsenko	プロツェンコ	Проценко
Protsenko	プロツェンコ
Прошин
Proshin	プロシン	Прошина
Proshina	プロシナ
Прямухин
Pryamukhin	プリャムヒン	Прямухина
Pryamukhina	プリャムヒナ
Пугачёв
Pugachyov	プガチョフ	Пугачёва
Pugachyova	プガチョヴァ
Пузановский
Puzanovsky	プザノフスキー	Пузановская
Puzanovskaya	プザノフスカヤ
Путилов
Putilov	プチロフ	Путилова
Putilova	プチロヴァ
Путин
Putin	プーチン	Путина
Putina	プーチナ
Пушкарёв
Pushkaryov	プシュカリョフ	Пушкарёва
Pushkaryova	プシュカリョヴァ
Пушкин
Pushkin	プーシュキン（プーシキン）	Пушкина
Pushkina	プーシュキナ
Пчёлкин
Pchyolkin	プチョールキン	Пчёлкина
Pchyolkina	プチョールキナ
Пыльнев
Pylnev	プィリネフ	Пыльнева
Pylneva	プィリネヴァ
Рабданов
Rabdanov	ラブダノフ	Рабданова
Rabdanova	ラブダノヴァ
Работяжев
Rabotyazhev	ラボチャジェフ	Работяжева
Rabotyazheva	ラボチャジェヴァ
Радзинский
Radzinsky	ラジンスキー	Радзинская
Radzinskaya	ラジンスカヤ
Радулов
Radulov	ラドゥロフ	Радулова
Radulova	ラドゥロヴァ
Ражев
Razhev	ラジェフ	Ражева
Razheva	ラジェヴァ
Раздухов
Razdukhov	ラズドゥホフ	Раздухова
Razdukhova	ラズドゥホヴァ
Разимов
Razimov	ラジモフ	Разимова
Razimova	ラジモヴァ
Райков
Raykov	ライコフ	Райкова
Raykova	ライコヴァ
Ракитов
Rakitov	ラキトフ	Ракитова
Rakitova	ラキトヴァ
Раков
Rakov	ラーコフ、ラコフ	Ракова
Rakova	ラーコヴァ、ラコヴァ
Распутин
Rasputin	ラスプーチン	Распутина
Rasputina	ラスプーチナ
Рассолов
Rassolov	ラッソロフ	Рассолова
Rassolova	ラッソロヴァ
Рассохин
Rassokhin	ラッソヒン	Рассохина
Rassokhina	ラッソヒナ
Расторгуев
Rastorguyev	ラストルグエフ	Расторгуева
Rastorguyeva	ラストルグエヴァ
Рахманин
Rakhmanin	ラフマニン	Рахманина
Rakhmanina	ラフマニナ
Рачёв
Rachyov	ラチョフ	Рачёва
Rachyova	ラチョヴァ
Редькин
Redkin	レチキン	Редькина
Redkina	レチキナ
Резайкин
Rezaykin	レザイキン	Резайкина
Rezaykina	レザイキナ
Ренов
Renov	レノフ	Ренова
Renova	レノヴァ
Репин
Repin	レーピン	Репина
Repina	レーピナ
Репкин
Repkin	レプキン	Репкина
Repkina	レプキナ
Ресин
Resin	レーシン	Ресина
Resina	レーシナ
Решетников
Reshetnikov	レシェートニコフ	Решетникова
Reshetnikova	レシェートニコヴァ
Решульский
Reshulsky	レシュリスキー	Решульская
Reshulskaya	レシュリスカヤ
Рогачёв
Rogachyov	ロガチョフ	Рогачёва
Rogachyova	ロガチョヴァ
Рогов
Rogov	ローゴフ	Рогова
Rogova	ローゴヴァ
Роговский
Rogovsky	ロゴフスキー	Роговская
Rogovskaya	ロゴフスカヤ
Родин
Rodin	ロージン	Родина
Rodina	ロージナ
Родионов
Rodionov	ロジオノフ	Родионова
Rodionova	ロジオノヴァ
Роднин
Rodnin	ロドニン	Роднина
Rodnina	ロドニナ
Родченко
Rodchenko	ロトチェンコ	Родченко
Rodchenko	ロトチェンコ
Рожков
Rozhkov	ロシュコフ、ロシュコーフ	Рожкова
Rozhkova	ロシュコヴァ、ロシュコーヴァ
Романенко
Romanenko	ロマネンコ	Романенко
Romanenko	ロマネンコ
Романов
Romanov	ロマノフ	Романова
Romanova	ロマノヴァ
Романовский
Romanovsky	ロマノフスキー	Романовская
Romanovskaya	ロマノフスカヤ
Ромашкин
Romashkin	ロマーシュキン	Ромашкина
Romashkina	ロマーシュキナ
Рохлин
Rokhlin	ロフリン	Рохлина
Rokhlina	ロフリナ
Рощин
Roshchin	ローシン、ローシチン	Рощина
Roshchina	ローシナ、ローシチナ
Рубанов
Rubanov	ルバノフ	Рубанова
Rubanova	ルバノヴァ
Рудников
Rudnikov	ルドニコフ	Рудникова
Rudnikova	ルドニコヴァ
Ружков
Ruzhkov	ルシュコフ	Ружкова
Ruzhkova	ルシュコヴァ
Рузиматов
Ruzimatov	ルジマートフ	Рузиматова
Ruzimatova	ルジマートヴァ
Румянцев
Rumyantsev	ルミャンツェフ	Румянцева
Rumyantseva	ルミャンツェヴァ
Рунов
Runov	ルノフ	Рунова
Runova	ルノヴァ
Рупасов
Rupasov	ルパソフ	Рупасова
Rupasova	ルパソヴァ
Русаков
Rusakov	ルサコーフ	Русакова
Rusakova	ルサコーヴァ
Русин
Rusin	ルーシン、ルシーン	Русина
Rusina	ルーシナ、ルシーナ
Русинов
Rusinov	ルシーノフ	Русинова
Rusinova	ルシーノヴァ
Рутковский
Rutkovsky	ルトコフスキー	Рутковская
Rutkovskaya	ルトコフスカヤ
Рыбаков
Rybakov	ルィバコフ	Рыбакова
Rybakova	ルィバコヴァ
Рыбалкин
Rybalkin	ルィバルキン	Рыбалкина
Rybalkina	ルィバルキナ
Рыбкин
Rybkin	ルィプキン	Рыбкина
Rybkina	ルィプキナ
Рыгалов
Rygalov	ルィガロフ	Рыгалова
Rygalova	ルィガロヴァ
Рыжков
Ryzhkov	ルィシュコフ	Рыжкова
Ryzhkova	ルィシュコヴァ
Рыжов
Ryzhov	ルィジョフ	Рыжова
Ryzhova	ルィジョヴァ
Рыжонков
Ryzhonkov	ルィジョンコフ	Рыжонкова
Ryzhonkova	ルィジョンコヴァ
Рындовский
Ryndovsky	ルィンドフスキー	Рындовская
Ryndovskaya	ルィンドフスカヤ
Рюриков
Ryurikov	リュリコフ	Рюрикова
Ryurikova	リュリコヴァ
Рябев
Ryabev	リャベフ	Рябева
Ryabeva	リャベヴァ
Рябенко
Ryabenko	リャベンコ	Рябенко
Ryabenko	リャベンコ
Рябинский
Ryabinsky	リャビンスキー	Рябинская
Ryabinskaya	リャビンスカヤ
Рябов
Ryabov	リャボフ	Рябова
Ryabova	リャボヴァ
Рябухин
Ryabukhin	リャブヒン	Рябухина
Ryabukhina	リャブヒナ
Рязанов
Ryazanov	リャザノフ	Рязанова
Ryazanova	リャザノヴァ
Саблин
Sablin	サブリン	Саблина
Sablina	サブリナ
Сабуров
Saburov	サブロフ	Сабурова
Saburova	サブロヴァ
Савельев
Savelev	サヴェリエフ	Савельева
Saveleva	サヴェリエヴァ
Савин
Savin	サヴィン	Савина
Savina	サヴィナ
Савинков
Savinkov	サーヴィンコフ	Савинкова
Savinkova	サーヴィンコヴァ
Савицкий
Savitsky	サヴィツキー	Савицкая
Savitskaya	サヴィツカヤ
Савостин
Savostin	サヴォスチン	Савостина
Savostina	サヴォスチナ
Савостьянов
Savostyanov	サヴォスチヤノフ	Савостьянова
Savostyanova	サヴォスチヤノヴァ
Савченко
Savchenko	サフチェンコ	Савченко
Savchenko	サフチェンコ
Саганов
Saganov	サガノフ	Саганова
Saganova	サガノヴァ
Садомский
Sadomsky	サドムスキー	Садомская
Sadomskaya	サドムスカヤ
Садчиков
Sadchikov	サッチコフ	Садчикова
Sadchikova	サッチコヴァ
Саенко
Sayenko	サエンコ	Саенко
Sayenko	サエンコ
Сажинов
Sazhinov	サジノフ	Сажинова
Sazhinova	サジノヴァ
Сазонов
Sazonov	サゾノフ	Сазонова
Sazonova	サゾノヴァ
Саитов
Saitov	サイートフ	Саитова
Saitova	サイートヴァ
Сайфуллин
Sayfullin	サイフーリン	Сайфуллина
Sayfullina	サイフーリナ
Салмин
Salmin	サルミン	Салмина
Salmina	サルミナ
Салов
Salov	サーロフ	Салова
Salova	サーロヴァ
Салтыков
Saltykov	サルトィコフ	Салтыкова
Saltykova	サルトィコヴァ
Сальников
Salnikov	サリニコフ	Сальникова
Salnikova	サリニコヴァ
Самарин
Samarin	サマリン	Самарина
Samarina	サマリナ
Самойлов
Samoylov	サモイロフ	Самойлова
Samoylova	サモイロヴァ
Самсонов
Samsonov	サムソノフ	Самсонова
Samsonova	サムソノヴァ
Самусев
Samusev	サムセフ	Самусева
Samuseva	サムセヴァ
Санаев
Sanayev	サナエフ	Санаева
Sanayeva	サナエヴァ
Санжаров
Sanzharov	サンジャロフ	Санжарова
Sanzharova	サンジャロヴァ
Саповский
Sapovsky	サポフスキー	Саповская
Sapovskaya	サポフスカヤ
Сапожников
Sapozhnikov	サポーズニコフ	Сапожникова
Sapozhnikova	サポーズニコヴァ
Сараев
Sarayev	サラエフ	Сараева
Sarayeva	サラエヴァ
Сарафанов
Sarafanov	サラファノフ	Сарафанова
Sarafanova	サラファノヴァ
Сарычев
Sarychev	サルィチェフ	Сарычева
Sarycheva	サルィチェヴァ
Сатаров
Satarov	サタロフ	Сатарова
Satarova	サタロヴァ
Саунин
Saunin	サウニン	Саунина
Saunina	サウニナ
Сафонов
Safonov	サフォノフ	Сафонова
Safonova	サフォノヴァ
Сафронов
Safronov	サフロノフ	Сафронова
Safronova	サフロノヴァ
Сахаров
Sakharov	サハロフ	Сахарова
Sakharova	サハロヴァ
Сахновский
Sakhnovsky	サフノフスキー	Сахновская
Sakhnovskaya	サフノフスカヤ
Светкин
Svetkin	スヴェトキン	Светкина
Svetkina	スヴェトキナ
Свечников
Svechnikov	スヴェチニコフ	Свечникова
Svechnikova	スヴェチニコヴァ
Свинаренко
Svinarenko	スヴィナレンコ	Свинаренко
Svinarenko	スヴィナレンコ
Свинин
Svinin	スヴィーニン	Свинина
Svinina	スヴィーニナ
Себенцов
Sebentsov	セベンツォフ	Себенцова
Sebentsova	セベンツォヴァ
Севастьянов
Sevastyanov	セヴァスチヤーノフ	Севастьянова
Sevastyanova	セヴァスチヤーノヴァ
Севрюгин
Sevryugin	セヴリューギン	Севрюгина
Sevryugina	セヴリューギナ
Седов
Sedov	セドフ	Седова
Sedova	セドヴァ
Седых
Sedykh	セドィフ	Седых
Sedykh	セドィフ
Селезнёв
Seleznyov	セレズニョフ	Селезнёва
Seleznyova	セレズニョヴァ
Селиванов
Selivanov	セリヴァノフ	Селиванова
Selivanova	セリヴァノヴァ
Селиверстов
Seliverstov	セリヴェルストフ	Селиверстова
Seliverstova	セリヴェルストヴァ
Селюнин
Selyunin	セリューニン	Селюнина
Selyunina	セリューニナ
Селютин
Selyutin	セリュチン	Селютина
Selyutina	セリュチナ
Селюцкий
Selyutsky	セリュツキー	Селюцкая
Selyutskaya	セリュツカヤ
Семёнов
Semyonov	セミョーノフ	Семёнова
Semyonova	セミョーノヴァ
Семенченко
Semenchenko	セメンチェンコ	Семенченко
Semenchenko	セメンチェンコ
Семернёв
Semernyov	セメルニョフ	Семернёва
Semernyova	セメルニョヴァ
Семуков
Semukov	セムコフ	Семукова
Semukova	セムコヴァ
Сенаторов
Senatorov	セナトロフ	Сенаторова
Senatorova	セナトロヴァ
Сенин
Senin	セーニン	Сенина
Senina	セーニナ
Сенников
Sennikov	センニコフ	Сенникова
Sennikova	センニコヴァ
Сергеев
Sergeyev	セルゲーエフ	Сергеева
Sergeyeva	セルゲーエヴァ
Сергеенков
Sergeyenkov	セルゲエンコフ	Сергеенкова
Sergeyenkova	セルゲエンコヴァ
Сергиенко
Sergiyenko	セルギエンコ	Сергиенко
Sergiyenko	セルギエンコ
Сердюков
Serdyukov	セルジュコフ	Сердюкова
Serdyukova	セルジュコヴァ
Серебряков
Serebryakov	セレブリャコフ	Серебрякова
Serebryakova	セレブリャコヴァ
Серёгин
Seryogin	セリョーギン	Серёгина
Seryogina	セリョーギナ
Серов
Serov	セロフ	Серова
Serova	セロヴァ
Серяков
Seryakov	セリャコフ	Серякова
Seryakova	セリャコヴァ
Сеславинский
Seslavinsky	セスラヴィンスキー	Сеславинская
Seslavinskaya	セスラヴィンスカヤ
Сигарев
Sigarev	シーガレフ	Сигарева
Sigareva	シーガレヴァ
Сидельников
Sidelnikov	シジェリニコフ	Сидельникова
Sidelnikova	シジェリニコヴァ
Сиденко
Sidenko	シジェンコ	Сиденко
Sidenko	シジェンコ
Сидоренко
Sidorenko	シドレンコ	Сидоренко
Sidorenko	シドレンコ
Сидоров
Sidorov	シードロフ	Сидорова
Sidorova	シードロヴァ
Сизов
Sizov	シゾフ	Сизова
Sizova	シゾヴァ
Силин
Silin	シーリン	Силина
Silina	シーリナ
Симаков
Simakov	シマコフ	Симакова
Simakova	シマコヴァ
Симахин
Simakhin	シマヒン	Симахина
Simakhina	シマヒナ
Симонов
Simonov	シーモノフ	Симонова
Simonova	シーモノヴァ
Синицын
Sinitsyn	シニツィン	Синицына
Sinitsyna	シニツィナ
Сиренко
Sirenko	シレンコ	Сиренко
Sirenko	シレンコ
Сиротенко
Sirotenko	シロチェンコ	Сиротенко
Sirotenko	シロチェンコ
Сироткин
Sirotkin	シロトキン	Сироткина
Sirotkina	シロトキナ
Ситников
Sitnikov	シトニコフ	Ситникова
Sitnikova	シトニコヴァ
Скачков
Skachkov	スカチコフ	Скачкова
Skachkova	スカチコヴァ
Скворцов
Skvortsov	スクヴォルツォフ	Скворцова
Skvortsova	スクヴォルツォヴァ
Скляров
Sklyarov	スクリャロフ	Склярова
Sklyarova	スクリャロヴァ
Скоков
Skokov	スコーコフ	Скокова
Skokova	スコーコヴァ
Скоповский
Skopovsky	スコポフスキー	Скоповская
Skopovskaya	スコポフスカヤ
Скороходов
Skorokhodov	スコロホドフ	Скороходова
Skorokhodova	スコロホドヴァ
Скорочкин
Skorochkin	スコロチキン	Скорочкина
Skorochkina	スコロチキナ
Скрипов
Skripov	スクリポフ	Скрипова
Skripova	スクリポヴァ
Скрипченко
Skripchenko	スクリプチェンコ	Скрипченко
Skripchenko	スクリプチェンコ
Скрябин
Skryabin	スクリャービン	Скрябина
Skryabina	スクリャービナ
Скурихин
Skurikhin	スクリーヒン	Скурихина
Skurikhina	スクリーヒナ
Слезкин
Slezkin	スレスキン	Слезкина
Slezkina	スレスキナ
Слепцов
Sleptsov	スレプツォフ	Слепцова
Sleptsova	スレプツォヴァ
Слуцкий
Slutsky	スルツキー	Слуцкая
Slutskaya	スルツカヤ
Смагин
Smagin	スマーギン	Смагина
Smagina	スマーギナ
Смекалов
Smekalov	スメカロフ	Смекалова
Smekalova	スメカロヴァ
Сметанкин
Smetankin	スメタンキン	Сметанкина
Smetankina	スメタンキナ
Смирнов
Smirnov	スミルノフ	Смирнова
Smirnova	スミルノヴァ
Смирнягин
Smirnyagin	スミルニャギン	Смирнягина
Smirnyagina	スミルニャギナ
Смоленцев
Smolentsev	スモレンツェフ	Смоленцева
Smolentseva	スモレンツェヴァ
Смолин
Smolin	スモーリン	Смолина
Smolina	スモーリナ
Смоляков
Smolyakov	スモリャコフ	Смолякова
Smolyakova	スモリャコヴァ
Снежков
Snezhkov	スネシュコフ	Снежкова
Snezhkova	スネシュコヴァ
Собакин
Sobakin	ソバキン	Собакина
Sobakina	ソバキナ
Соболев
Sobolev	ソボレフ	Соболева
Soboleva	ソボレヴァ
Собянин
Sobyanin	ソビャニン	Собянина
Sobyanina	ソビャニナ
Соколин
Sokolin	ソコリン	Соколина
Sokolina	ソコリナ
Соколов
Sokolov	ソコロフ	Соколова
Sokolova	ソコロヴァ
Солженицын
Solzhenitsyn	ソルジェニーツィン	Солженицына
Solzhenitsyna	ソルジェニーツィナ
Солкин
Solkin	ソルキン	Солкина
Solkina	ソルキナ
Соловов
Solovov	ソロヴォフ	Соловова
Solovova	ソロヴォヴァ
Соловьёв
Solovyov	ソロヴィヨフ	Соловьёва
Solovyova	ソロヴィヨヴァ
Соловьянов
Solovyanov	ソロヴィヤノフ	Соловьянова
Solovyanova	ソロヴィヤノヴァ
Соломатин
Solomatin	ソロマチン	Соломатина
Solomatina	ソロマチナ
Соломаткин
Solomatkin	ソロマトキン	Соломаткина
Solomatkina	ソロマトキナ
Соломов
Solomov	ソロモフ	Соломова
Solomova	ソロモヴァ
Солуянов
Soluyanov	ソルヤノフ	Солуянова
Soluyanova	ソルヤノヴァ
Сомов
Somov	ソーモフ、ソモフ	Сомова
Somova	ソーモヴァ、ソモヴァ
Сорокин
Sorokin	ソローキン	Сорокина
Sorokina	ソローキナ
Сотников
Sotnikov	ソトニコフ	Сотникова
Sotnikova	ソトニコヴァ
Сохов
Sokhov	ソホフ	Сохова
Sokhova	ソホヴァ
Сочилин
Sochilin	ソチリン	Сочилина
Sochilina	ソチリナ
Спесивцев
Spesivtsev	スペシフツェフ	Спесивцева
Spesivtseva	スペシフツェヴァ
Спиридонов
Spiridonov	スピリドノフ	Спиридонова
Spiridonova	スピリドノヴァ
Стариков
Starikov	スタリコフ	Старикова
Starikova	スタリコヴァ
Старовойтов
Starovoytov	スタロヴォイトフ	Старовойтова
Starovoytova	スタロヴォイトヴァ
Стародубов
Starodubov	スタロドゥボフ	Стародубова
Starodubova	スタロドゥボヴァ
Стародубцев
Starodubtsev	スタロドゥプツェフ	Стародубцева
Starodubtseva	スタロドゥプツェヴァ
Старостин
Starostin	スタロスチン	Старостина
Starostina	スタロスチナ
Старчуков
Starchukov	スタルチュコフ	Старчукова
Starchukova	スタルチュコヴァ
Старыгин
Starygin	スタルィギン	Старыгина
Starygina	スタルィギナ
Степаненко
Stepanenko	スチェパネンコ、ステパネンコ	Степаненко
Stepanenko	スチェパネンコ、ステパネンコ
Степанков
Stepankov	スチェパンコフ	Степанкова
Stepankova	スチェパンコヴァ
Степанов
Stepanov	スチェパノフ	Степанова
Stepanova	スチェパノヴァ
Степашин
Stepashin	スチェパーシン	Степашина
Stepashina	スチェパーシナ
Стерлигов
Sterligov	スチェルリゴフ	Стерлигова
Sterligova	スチェルリゴヴァ
Стифунин
Stifunin	スチフーニン	Стифунина
Stifunina	スチフーニナ
Столбов
Stolbov	ストルボフ	Столбова
Stolbova	ストルボヴァ
Столыпин
Stolypin	ストルィピン、ストルイピン	Столыпина
Stolypina	ストルィピナ、ストルイピナ
Столяров
Stolyarov	ストリャロフ	Столярова
Stolyarova	ストリャロヴァ
Стороженко
Storozhenko	ストロジェンコ	Стороженко
Storozhenko	ストロジェンコ
Страхов
Strakhov	ストラホフ	Страхова
Strakhova	ストラホヴァ
Стрелков
Strelkov	ストレルコフ	Стрелкова
Strelkova	ストレルコヴァ
Стригин
Strigin	ストリギン	Стригина
Strigina	ストリギナ
Строев
Stroyev	ストロエフ	Строева
Stroyeva	ストロエヴァ
Стругов
Strugov	ストルゴフ	Стругова
Strugova	ストルゴヴァ
Стрыгин
Strygin	ストルィギン	Стрыгина
Strygina	ストルィギナ
Стукальский
Stukalsky	ストゥカリスキー	Стукальская
Stukalskaya	ストゥカリスカヤ
Ступников
Stupnikov	ストゥプニコフ	Ступникова
Stupnikova	ストゥプニコヴァ
Стуров
Sturov	ストゥロフ	Стурова
Sturova	ストゥロヴァ
Субботин
Subbotin	スッボーチン	Субботина
Subbotina	スッボーチナ
Суворинов
Suvorinov	スヴォリノフ	Суворинова
Suvorinova	スヴォリノヴァ
Суворов
Suvorov	スヴォロフ	Суворова
Suvorova	スヴォロヴァ
Сударенков
Sudarenkov	スダレンコフ	Сударенкова
Sudarenkova	スダレンコヴァ
Суденков
Sudenkov	スジェンコフ	Суденкова
Sudenkova	スジェンコヴァ
Сулакшин
Sulakshin	スラクシン	Сулакшина
Sulakshina	スラクシナ
Сумароков
Sumarokov	スマロコフ	Сумарокова
Sumarokova	スマロコヴァ
Сурайкин
Suraykin	スライキン	Сурайкина
Suraykina	スライキナ
Сурганов
Surganov	スルガノフ	Сурганова
Surganova	スルガノヴァ
Суренков
Surenkov	スレンコフ	Суренкова
Surenkova	スレンコヴァ
Суржиков
Surzhikov	スルジコフ	Суржикова
Surzhikova	スルジコヴァ
Суриков
Surikov	スリコフ	Сурикова
Surikova	スリコヴァ
Сурков
Surkov	スルコフ	Суркова
Surkova	スルコヴァ
Суров
Surov	スーロフ	Сурова
Surova	スーロヴァ
Суслов
Suslov	スースロフ	Суслова
Suslova	スースロヴァ
Сутурин
Suturin	ストゥーリン	Сутурина
Suturina	ストゥーリナ
Суханов
Sukhanov	スハノフ	Суханова
Sukhanova	スハノヴァ
Сухов
Sukhov	スーホフ	Сухова
Sukhova	スーホヴァ
Сысоев
Sysoyev	スィソエフ	Сысоева
Sysoyeva	スィソエヴァ
Сысуев
Sysuyev	スィスエフ	Сысуева
Sysuyeva	スィスエヴァ
Сычёв
Sychyov	スィチョフ、シチョフ	Сычёва
Sychyova	スィチョヴァ、シチョヴァ
Сюткин
Syutkin	シュトキン	Сюткина
Syutkina	シュトキナ
Табаев
Tabayev	タバエフ	Табаева
Tabayeva	タバエヴァ
Таболин
Tabolin	タボリン	Таболина
Tabolina	タボリナ
Таланов
Talanov	タラノフ	Таланова
Talanova	タラノヴァ
Таранцов
Tarantsov	タランツォフ	Таранцова
Tarantsova	タランツォヴァ
Тарасенко
Tarasenko	タラセンコ	Тарасенко
Tarasenko	タラセンコ
Тарасов
Tarasov	タラソフ	Тарасова
Tarasova	タラソヴァ
Тарачев
Tarachev	タラチェフ	Тарачева
Taracheva	タラチェヴァ
Тарковский
Tarkovsky	タルコフスキー	Тарковская
Tarkovskaya	タルコフスカヤ
Татауров
Tataurov	タタウロフ	Татаурова
Tataurova	タタウロヴァ
Татков
Tatkov	タトコフ	Таткова
Tatkova	タトコヴァ
Телятников
Telyatnikov	チェリャトニコフ	Телятникова
Telyatnikova	チェリャトニコヴァ
Темиржанов
Temirzhanov	チェミルジャノフ	Темиржанова
Temirzhanova	チェミルジャノヴァ
Терентьев
Terentev	チェレンチェフ	Терентьева
Terenteva	チェレンチェヴァ
Терехов
Terekhov	チェレホフ	Терехова
Terekhova	チェレホヴァ
Терёшкин
Teryoshkin	チェリョーシュキン	Терёшкина
Teryoshkina	チェリョーシュキナ
Терешков
Tereshkov	チェレシュコフ	Терешкова
Tereshkova	チェレシュコヴァ
Терещенко
Tereshchenko	チェレーシェンコ、チェレーシチェンコ	Терещенко
Tereshchenko	チェレーシェンコ、チェレーシチェンコ
Тетельмин
Tetelmin	チェチェリミン	Тетельмина
Tetelmina	チェチェリミナ
Тетерин
Teterin	チェチェリン	Тетерина
Teterina	チェチェリナ
Тимофеев
Timofeyev	チモフェーエフ	Тимофеева
Timofeyeva	チモフェーエヴァ
Тимошенко
Timoshenko	チモシェンコ	Тимошенко
Timoshenko	チモシェンコ
Титенко
Titenko	チチェンコ	Титенко
Titenko	チチェンコ
Титкин
Titkin	チトキン	Титкина
Titkina	チトキナ
Титов
Titov	チトーフ	Титова
Titova	チトーヴァ
Тихомиров
Tikhomirov	チホミロフ	Тихомирова
Tikhomirova	チホミロヴァ
Тихонов
Tikhonov	チーホノフ	Тихонова
Tikhonova	チーホノヴァ
Ткачёв
Tkachyov	トカチョフ	Ткачёва
Tkachyova	トカチョヴァ
Ткаченко
Tkachenko	トカチェンコ	Ткаченко
Tkachenko	トカチェンコ
Токарев
Tokarev	トーカレフ、トカレフ	Токарева
Tokareva	トーカレヴァ、トカレヴァ
Токуленко
Tokulenko	トクレンコ	Токуленко
Tokulenko	トクレンコ
Толкачёв
Tolkachyov	トルカチョフ	Толкачёва
Tolkachyova	トルカチョヴァ
Толмачёв
Tolmachyov	トルマチョフ	Толмачёва
Tolmachyova	トルマチョヴァ
Толстой
Tolstoy	トルストイ	Толстая
Tolstaya	トルスタヤ
Толстошеин
Tolstoshein	トルストシェイン	Толстошеина
Tolstosheina	トルストシェイナ
Томтосов
Tomtosov	トムトソフ	Томтосова
Tomtosova	トムトソヴァ
Томчин
Tomchin	トムチン	Томчина
Tomchina	トムチナ
Топорков
Toporkov	トポルコフ	Топоркова
Toporkova	トポルコヴァ
Топоров
Toporov	トポロフ	Топорова
Toporova	トポロヴァ
Торбин
Torbin	トルビン	Торбина
Torbina	トルビナ
Торлопов
Torlopov	トルロポフ	Торлопова
Torlopova	トルロポヴァ
Торопов
Toropov	トロポフ	Торопова
Toropova	トロポヴァ
Торхов
Torkhov	トルホフ	Торхова
Torkhova	トルホヴァ
Торшин
Torshin	トルシン	Торшина
Torshina	トルシナ
Тотиев
Totiyev	トチーエフ	Тотиева
Totiyeva	トチーエヴァ
Травкин
Travkin	トラフキン	Травкина
Travkina	トラフキナ
Травников
Travnikov	トラヴニコフ	Травникова
Travnikova	トラヴニコヴァ
Траспов
Traspov	トラスポフ	Траспова
Traspova	トラスポヴァ
Трегубов
Tregubov	トレグボフ	Трегубова
Tregubova	トレグボヴァ
Третьяков
Tretyakov	トレチヤコーフ	Третьякова
Tretyakova	トレチヤコーヴァ
Трефилов
Trefilov	トレフィロフ	Трефилова
Trefilova	トレフィロヴァ
Тропин
Tropin	トロピン	Тропина
Tropina	トロピナ
Трофимов
Trofimov	トロフィモフ	Трофимова
Trofimova	トロフィモヴァ
Троцкий
Trotsky	トロツキー	Троцкая
Trotskaya	トロツカヤ
Трошин
Troshin	トローシン	Трошина
Troshina	トローシナ
Трошкин
Troshkin	トロシュキン	Трошкина
Troshkina	トロシュキナ
Трубников
Trubnikov	トルブニコフ	Трубникова
Trubnikova	トルブニコヴァ
Трушников
Trushnikov	トルシュニコフ	Трушникова
Trushnikova	トルシュニコヴァ
Тубылов
Tubylov	トゥブィロフ	Тубылова
Tubylova	トゥブィロヴァ
Туинов
Tuinov	トゥイノフ	Туинова
Tuinova	トゥイノヴァ
Туктамышев
Tuktamyshev	トゥクタムイシェフ	Туктамышева
Tuktamysheva	トゥクタムイシェヴァ
Туманов
Tumanov	トゥマーノフ	Туманова
Tumanova	トゥマーノヴァ
Турбанов
Turbanov	トゥルバノフ	Турбанова
Turbanova	トゥルバノヴァ
Турбин
Turbin	トゥルビン	Турбина
Turbina	トゥルビナ
Тургенев
Turgenev	トゥルゲーネフ（ツルゲーネフ）	Тургенева
Turgeneva	トゥルゲーネヴァ
Туров
Turov	トゥーロフ	Турова
Turova	トゥーロヴァ
Турусин
Turusin	トゥルシン	Турусина
Turusina	トゥルシナ
Тучков
Tuchkov	トゥチコフ	Тучкова
Tuchkova	トゥチコヴァ
Тюнеев
Tyuneyev	チュネーエフ	Тюнеева
Tyuneyeva	チュネーエヴァ
Тягачев
Tyagachev	チャガチェフ	Тягачева
Tyagacheva	チャガチェヴァ
Тягунов
Tyagunov	チャグノフ	Тягунова
Tyagunova	チャグノヴァ
Тяжлов
Tyazhlov	チャズロフ	Тяжлова
Tyazhlova	チャズロヴァ
Уваров
Uvarov	ウヴァーロフ	Уварова
Uvarova	ウヴァーロヴァ
Увачан
Uvachan	ウヴァチャン	Увачана
Uvachana	ウヴァチャナ
Удовенко
Udovenko	ウドヴェンコ	Удовенко
Udovenko	ウドヴェンコ
Уланов
Ulanov	ウラノフ、ウラーノフ	Уланова
Ulanova	ウラノヴァ、ウラーノヴァ
Улицкий
Ulitsky	ウリツキー	Улицкая
Ulitskaya	ウリツカヤ
Улыбин
Ulybin	ウルィビン	Улыбина
Ulybina	ウルィビナ
Ульянов
Ulyanov	ウリヤノフ	Ульянова
Ulyanova	ウリヤノヴァ
Уринсон
Urinson	ウリンソン	Уринсона
Urinsona	ウリンソナ
Урманов
Urmanov	ウルマーノフ	Урманова
Urmanova	ウルマーノヴァ
Урнов
Urnov	ウルノフ	Урнова
Urnova	ウルノヴァ
Урывин
Uryvin	ウルィヴィン	Урывина
Uryvina	ウルィヴィナ
Усачев
Usachev	ウサーチェフ	Усачева
Usacheva	ウサーチェヴァ
Усов
Usov	ウーソフ	Усова
Usova	ウーソヴァ
Успенский
Uspensky	ウスペンスキー	Успенская
Uspenskaya	ウスペンスカヤ
Устинов
Ustinov	ウスチノフ	Устинова
Ustinova	ウスチノヴァ
Устюгов
Ustyugov	ウスチュゴフ	Устюгова
Ustyugova	ウスチュゴヴァ
Уткин
Utkin	ウトキン	Уткина
Utkina	ウトキナ
Уханев
Ukhanev	ウハネフ	Уханева
Ukhaneva	ウハネヴァ
Ушаков
Ushakov	ウシャコフ	Ушакова
Ushakova	ウシャコヴァ
Фадеев
Fadeyev	ファジェーエフ	Фадеева
Fadeyeva	ファジェーエヴァ
Фалалеев
Falaleyev	ファラレーエフ	Фалалеева
Falaleyeva	ファラレーエヴァ
Фалеев
Faleyev	ファレエフ	Фалеева
Faleyeva	ファレエヴァ
Фандорин
Fandorin	ファンドーリン	Фандорина
Fandorina	ファンドーリナ
Фархутдинов
Farkhutdinov	ファルフジノフ	Фархутдинова
Farkhutdinova	ファルフジノヴァ
Фатеев
Fateyev	ファチェーエフ	Фатеева
Fateyeva	ファチェーエヴァ
Фаткулин
Fatkulin	ファトクーリン	Фаткулина
Fatkulina	ファトクーリナ
Федичев
Fedichev	フェジーチェフ	Федичева
Fedicheva	フェジーチェヴァ
Фёдоров
Fyodorov	フョードロフ	Фёдорова
Fyodorova	フョードロヴァ
Федосеев
Fedoseyev	フェドセーエフ	Федосеева
Fedoseyeva	フェドセーエヴァ
Федосов
Fedosov	フェドソフ	Федосова
Fedosova	フェドソヴァ
Федотов
Fedotov	フェドトフ	Федотова
Fedotova	フェドトヴァ
Федянин
Fedyanin	フェジャニン	Федянина
Fedyanina	フェジャニナ
Фейгин
Feygin	フェイギン	Фейгина
Feygina	フェイギナ
Фетисов
Fetisov	フェチソフ	Фетисова
Fetisova	フェチソヴァ
Филалеев
Filaleyev	フィラレーエフ	Филалеева
Filaleyeva	フィラレーエヴァ
Филатов
Filatov	フィラトフ	Филатова
Filatova	フィラトヴァ
Филенков
Filenkov	フィレンコフ	Филенкова
Filenkova	フィレンコヴァ
Филимонов
Filimonov	フィリモーノフ	Филимонова
Filimonova	フィリモーノヴァ
Филипенко
Filipenko	フィリペンコ	Филипенко
Filipenko	フィリペンコ
Филиппов
Filippov	フィリッポフ	Филиппова
Filippova	フィリッポヴァ
Фильшин
Filshin	フィリシン	Фильшина
Filshina	フィリシナ
Флистенко
Flistenko	フリスチェンコ	Флистенко
Flistenko	フリスチェンコ
Фокин
Fokin	フォーキン	Фокина
Fokina	フォーキナ
Фоменко
Fomenko	フォメンコ	Фоменко
Fomenko	フォメンコ
Фомин
Fomin	フォミーン	Фомина
Fomina	フォミーナ
Фомичёв
Fomichyov	フォミチョーフ	Фомичёва
Fomichyova	フォミチョーヴァ
Фонотов
Fonotov	フォノトフ	Фонотова
Fonotova	フォノトヴァ
Фортов
Fortov	フォルトフ	Фортова
Fortova	フォルトヴァ
Фрадков
Fradkov	フラトコフ	Фрадкова
Fradkova	フラトコヴァ
Фролов
Frolov	フロロフ	Фролова
Frolova	フロロヴァ
Фурманов
Furmanov	フルマノフ	Фурманова
Furmanova	フルマノヴァ
Хабаров
Khabarov	ハバロフ	Хабарова
Khabarova	ハバロヴァ
Хайрюзов
Khayryuzov	ハイリューゾフ	Хайрюзова
Khayryuzova	ハイリューゾヴァ
Хакимов
Khakimov	ハキーモフ	Хакимова
Khakimova	ハキーモヴァ
Халевинский
Khalevinsky	ハレヴィンスキー	Халевинская
Khalevinskaya	ハレヴィンスカヤ
Халилов
Khalilov	ハリロフ	Халилова
Khalilova	ハリロヴァ
Хандруев
Khandruyev	ハンドルエフ	Хандруева
Khandruyeva	ハンドルエヴァ
Хапов
Khapov	ハーポフ	Хапова
Khapova	ハーポヴァ
Харитонов
Kharitonov	ハリトノフ	Харитонова
Kharitonova	ハリトノヴァ
Харламов
Kharlamov	ハルラモフ	Харламова
Kharlamova	ハルラモヴァ
Харлов
Kharlov	ハルロフ	Харлова
Kharlova	ハルロヴァ
Хачатуров
Khachaturov	ハチャトゥロフ	Хачатурова
Khachaturova	ハチャトゥロヴァ
Хачатурян
Khachaturyan	ハチャトゥリャン	Хачатуряна
Khachaturyana	ハチャトゥリャナ
Хватков
Khvatkov	フヴァトコフ	Хваткова
Khvatkova	フヴァトコヴァ
Хетагуров
Khetagurov	ヘタグロフ	Хетагурова
Khetagurova	ヘタグロヴァ
Хлебников
Khlebnikov	フレブニコフ	Хлебникова
Khlebnikova	フレブニコヴァ
Ходкин
Khodkin	ホトキン	Ходкина
Khodkina	ホトキナ
Ходырев
Khodyrev	ホードィレフ	Ходырева
Khodyreva	ホードィレヴァ
Хожателев
Khozhatelev	ホジャチェレフ	Хожателева
Khozhateleva	ホジャチェレヴァ
Хоменко
Khomenko	ホメンコ	Хоменко
Khomenko	ホメンコ
Хомутов
Khomutov	ホムトフ	Хомутова
Khomutova	ホムトヴァ
Хорошилов
Khoroshilov	ホロシロフ	Хорошилова
Khoroshilova	ホロシロヴァ
Хотиненко
Khotinenko	ホチネンコ	Хотиненко
Khotinenko	ホチネンコ
Хоточкин
Khotochkin	ホトチキン	Хоточкина
Khotochkina	ホトチキナ
Хохлов
Khokhlov	ホフロフ	Хохлова
Khokhlova	ホフロヴァ
Храмченков
Khramchenkov	フラムチェンコフ	Храмченкова
Khramchenkova	フラムチェンコヴァ
Хренков
Khrenkov	フレンコフ	Хренкова
Khrenkova	フレンコヴァ
Хритненков
Khritnenkov	フリトネンコフ	Хритненкова
Khritnenkova	フリトネンコヴァ
Хромушин
Khromushin	フロムシン	Хромушина
Khromushina	フロムシナ
Хрущёв
Khrushchyov	フルショフ、フルシチョフ	Хрущёва
Khrushchyova	フルショヴァ、フルシチョヴァ
Хрычёв
Khrychyov	フルィチョフ	Хрычёва
Khrychyova	フルィチョヴァ
Хубиев
Khubiyev	フビエフ	Хубиева
Khubiyeva	フビエヴァ
Худяев
Khudyayev	フジャーエフ	Худяева
Khudyayeva	フジャーエヴァ
Хумаров
Khumarov	フマロフ	Хумарова
Khumarova	フマロヴァ
Хутанов
Khutanov	フタノフ	Хутанова
Khutanova	フタノヴァ
Цапин
Tsapin	ツァピン	Цапина
Tsapina	ツァピナ
Царегородцев
Tsaregorodtsev	ツァレゴロートツェフ	Царегородцева
Tsaregorodtseva	ツァレゴロートツェヴァ
Царенко
Tsarenko	ツァレンコ	Царенко
Tsarenko	ツァレンコ
Царьков
Tsarkov	ツァリコフ	Царькова
Tsarkova	ツァリコヴァ
Цветков
Tsvetkov	ツヴェトコフ	Цветкова
Tsvetkova	ツヴェトコヴァ
Цепицин
Tsepitsin	ツェピツィン	Цепицина
Tsepitsina	ツェピツィナ
Цибульский
Tsibulsky	ツィブリスキー	Цибульская
Tsibulskaya	ツィブリスカヤ
Цыганенко
Tsyganenko	ツィガネンコ	Цыганенко
Tsyganenko	ツィガネンコ
Цыплаков
Tsyplakov	ツィプラコフ	Цыплакова
Tsyplakova	ツィプラコヴァ
Цыпляев
Tsyplyayev	ツィプリャエフ	Цыпляева
Tsyplyayeva	ツィプリャエヴァ
Чайковский
Chaykovsky	チャイコフスキー	Чайковская
Chaykovskaya	チャイコフスカヤ
Чаптынов
Chaptynov	チャプトィノフ	Чаптынова
Chaptynova	チャプトィノヴァ
Чебунин
Chebunin	チェブーニン	Чебунина
Chebunina	チェブーニナ
Чекмезов
Chekmezov	チェクメゾフ	Чекмезова
Chekmezova	チェクメゾヴァ
Чекрыгин
Chekrygin	チェクルィギン	Чекрыгина
Chekrygina	チェクルィギナ
Челноков
Chelnokov	チェルノコフ	Челнокова
Chelnokova	チェルノコヴァ
Челышев
Chelyshev	チェルィシェフ	Челышева
Chelysheva	チェルィシェヴァ
Ченчиков
Chenchikov	チェンチコフ	Ченчикова
Chenchikova	チェンチコヴァ
Червинский
Chervinsky	チェルヴィンスキー	Червинская
Chervinskaya	チェルヴィンスカヤ
Черемных
Cheremnykh	チェレムヌィフ	Черемных
Cheremnykh	チェレムヌィフ
Черёмухин
Cheryomukhin	チェリョムヒン	Черёмухина
Cheryomukhina	チェリョムヒナ
Черепков
Cherepkov	チェレプコフ	Черепкова
Cherepkova	チェレプコヴァ
Черкесов
Cherkesov	チェルケソフ	Черкесова
Cherkesova	チェルケソヴァ
Черненко
Chernenko	チェルネンコ	Черненко
Chernenko	チェルネンコ
Черниченко
Chernichenko	チェルニチェンコ	Черниченко
Chernichenko	チェルニチェンコ
Чернов
Chernov	チェルノフ	Чернова
Chernova	チェルノヴァ
Черногоров
Chernogorov	チェルノゴロフ	Черногорова
Chernogorova	チェルノゴロヴァ
Черноиванов
Chernoivanov	チェルノイヴァノフ	Черноиванова
Chernoivanova	チェルノイヴァノヴァ
Черномырдин
Chernomyrdin	チェルノムイルジン	Черномырдина
Chernomyrdina	チェルノムイルジナ
Черноусов
Chernousov	チェルノウソフ	Черноусова
Chernousova	チェルノウソヴァ
Черных
Chernykh	チェルヌィフ	Черных
Chernykh	チェルヌィフ
Чернышёв
Chernyshyov	チェルヌィショフ	Чернышёва
Chernyshyova	チェルヌィショヴァ
Чернышевский
Chernyshevsky	チェルヌィシェフスキー	Чернышевская
Chernyshevskaya	チェルヌィシェフスカヤ
Чернянский
Chernyansky	チェルニャンスキー	Чернянская
Chernyanskaya	チェルニャンスカヤ
Черчесов
Cherchesov	チェルチェソフ	Черчесова
Cherchesova	チェルチェソヴァ
Чесноков
Chesnokov	チェスノーコフ	Чеснокова
Chesnokova	チェスノーコヴァ
Четин
Chetin	チェチン	Четина
Chetina	チェチナ
Чехов
Chekhov	チェーホフ	Чехова
Chekhova	チェーホヴァ
Чехоев
Chekhoyev	チェホエフ	Чехоева
Chekhoyeva	チェホエヴァ
Чечеватов
Chechevatov	チェチェヴァトフ	Чечеватова
Chechevatova	チェチェヴァトヴァ
Чешенко
Cheshenko	チェシェンコ	Чешенко
Cheshenko	チェシェンコ
Чибисов
Chibisov	チビソフ	Чибисова
Chibisova	チビソヴァ
Чикин
Chikin	チーキン	Чикина
Chikina	チーキナ
Чилингаров
Chilingarov	チリンガロフ	Чилингарова
Chilingarova	チリンガロヴァ
Чириков
Chirikov	チリコフ	Чирикова
Chirikova	チリコヴァ
Чирцов
Chirtsov	チルツォフ	Чирцова
Chirtsova	チルツォヴァ
Чистяков
Chistyakov	チスチャコフ	Чистякова
Chistyakova	チスチャコヴァ
Чичелов
Chichelov	チチェロフ	Чичелова
Chichelova	チチェロヴァ
Членов
Chlenov	チレノフ	Членова
Chlenova	チレノヴァ
Чугуев
Chuguyev	チュグーエフ	Чугуева
Chuguyeva	チュグーエヴァ
Чудинов
Chudinov	チュジノフ	Чудинова
Chudinova	チュジノヴァ
Чуканов
Chukanov	チュカノフ	Чуканова
Chukanova	チュカノヴァ
Чуковский
Chukovsky	チューコフスキー、チュコフスキー	Чуковская
Chukovskaya	チューコフスカヤ、チュコフスカヤ
Чуньков
Chunkov	チュニコフ	Чунькова
Chunkova	チュニコヴァ
Чупин
Chupin	チューピン	Чупина
Chupina	チューピナ
Чуранов
Churanov	チュラノフ	Чуранова
Churanova	チュラノヴァ
Чурилов
Churilov	チュリロフ	Чурилова
Churilova	チュリロヴァ
Чуркин
Churkin	チュルキン	Чуркина
Churkina	チュルキナ
Чурков
Churkov	チュルコフ	Чуркова
Churkova	チュルコヴァ
Чухин
Chukhin	チューヒン	Чухина
Chukhina	チューヒナ
Чюльков
Chyulkov	チュリコフ	Чюлькова
Chyulkova	チュリコヴァ
Шабалин
Shabalin	シャバリン	Шабалина
Shabalina	シャバリナ
Шабанов
Shabanov	シャバノフ	Шабанова
Shabanova	シャバノヴァ
Шабдурасулов
Shabdurasulov	シャブドゥラスロフ	Шабдурасулова
Shabdurasulova	シャブドゥラスロヴァ
Шабунин
Shabunin	シャブニン	Шабунина
Shabunina	シャブニナ
Шадриков
Shadrikov	シャドリコフ	Шадрикова
Shadrikova	シャドリコヴァ
Шалавин
Shalavin	シャラーヴィン	Шалавина
Shalavina	シャラーヴィナ
Шаламов
Shalamov	シャラーモフ	Шаламова
Shalamova	シャラーモヴァ
Шамин
Shamin	シャミン	Шамина
Shamina	シャミナ
Шамов
Shamov	シャモフ	Шамова
Shamova	シャモヴァ
Шамраев
Shamrayev	シャムラエフ	Шамраева
Shamrayeva	シャムラエヴァ
Шамшин
Shamshin	シャムシン	Шамшина
Shamshina	シャムシナ
Шамшуров
Shamshurov	シャムシュロフ	Шамшурова
Shamshurova	シャムシュロヴァ
Шандыбин
Shandybin	シャンドィビン、シャンドイビン	Шандыбина
Shandybina	シャンドィビナ、シャンドイビナ
Шанкин
Shankin	シャンキン	Шанкина
Shankina	シャンキナ
Шапкин
Shapkin	シャプキン	Шапкина
Shapkina	シャプキナ
Шаповаленко
Shapovalenko	シャポヴァレンコ	Шаповаленко
Shapovalenko	シャポヴァレンコ
Шаповалов
Shapovalov	シャポヴァロフ	Шаповалова
Shapovalova	シャポヴァロヴァ
Шапошников
Shaposhnikov	シャポシュニコフ	Шапошникова
Shaposhnikova	シャポシュニコヴァ
Шарапов
Sharapov	シャラポフ	Шарапова
Sharapova	シャラポヴァ
Шаров
Sharov	シャローフ	Шарова
Sharova	シャローヴァ
Шаронов
Sharonov	シャロノフ	Шаронова
Sharonova	シャロノヴァ
Шарутенко
Sharutenko	シャルチェンコ	Шарутенко
Sharutenko	シャルチェンコ
Шарыгин
Sharygin	シャルィギン	Шарыгина
Sharygina	シャルィギナ
Шаталин
Shatalin	シャターリン	Шаталина
Shatalina	シャターリナ
Шаталов
Shatalov	シャタロフ	Шаталова
Shatalova	シャタロヴァ
Шафранов
Shafranov	シャフラノフ	Шафранова
Shafranova	シャフラノヴァ
Шахов
Shakhov	シャホフ	Шахова
Shakhova	シャホヴァ
Шашков
Shashkov	シャシュコーフ	Шашкова
Shashkova	シャシュコーヴァ
Шашурин
Shashurin	シャシューリン	Шашурина
Shashurina	シャシューリナ
Шведченко
Shvedchenko	シュヴェトチェンコ	Шведченко
Shvedchenko	シュヴェトチェンコ
Швецов
Shvetsov	シュヴェツォフ	Швецова
Shvetsova	シュヴェツォヴァ
Шевелёв
Shevelyov	シェヴェリョフ	Шевелёва
Shevelyova	シェヴェリョヴァ
Шевченко
Shevchenko	シェフチェンコ	Шевченко
Shevchenko	シェフチェンコ
Шереметьев
Sheremetev	シェレメチェフ	Шереметьева
Sheremeteva	シェレメチェヴァ
Шершунов
Shershunov	シェルシュノフ	Шершунова
Shershunova	シェルシュノヴァ
Шестаков
Shestakov	シェスタコフ	Шестакова
Shestakova	シェスタコヴァ
Шестов
Shestov	シェストフ	Шестова
Shestova	シェストヴァ
Шибаев
Shibayev	シバエフ	Шибаева
Shibayeva	シバエヴァ
Шилов
Shilov	シーロフ	Шилова
Shilova	シーロヴァ
Шипов
Shipov	シーポフ	Шипова
Shipova	シーポヴァ
Широбоков
Shirobokov	シロボコフ	Широбокова
Shirobokova	シロボコヴァ
Ширшов
Shirshov	シルショフ	Ширшова
Shirshova	シルショヴァ
Ширяев
Shiryayev	シリャーエフ	Ширяева
Shiryayeva	シリャーエヴァ
Шихалев
Shikhalev	シハレフ	Шихалева
Shikhaleva	シハレヴァ
Шичанин
Shichanin	シチャーニン	Шичанина
Shichanina	シチャーニナ
Шишкин
Shishkin	シシュキン、シーシキン	Шишкина
Shishkina	シシュキナ、シーシキナ
Шишков
Shishkov	シシュコフ	Шишкова
Shishkova	シシュコヴァ
Шишлов
Shishlov	シシュロフ	Шишлова
Shishlova	シシュロヴァ
Шкловский
Shklovsky	シュクロフスキー、シュクローフスキー	Шкловская
Shklovskaya	シュクロフスカヤ、シュクローフスカヤ
Шкляров
Shklyarov	シュクリャーロフ	Шклярова
Shklyarova	シュクリャーロヴァ
Шкрабов
Shkrabov	シュクラボフ	Шкрабова
Shkrabova	シュクラボヴァ
Шляпин
Shlyapin	シュリャピン	Шляпина
Shlyapina	シュリャピナ
Шляхтин
Shlyakhtin	シュリャフチン	Шляхтина
Shlyakhtina	シュリャフチナ
Шмаков
Shmakov	シュマーコフ	Шмакова
Shmakova	シュマーコヴァ
Шматов
Shmatov	シュマートフ	Шматова
Shmatova	シュマートヴァ
Шолохов
Sholokhov	ショーロホフ	Шолохова
Sholokhova	ショーロホヴァ
Шорин
Shorin	ショーリン	Шорина
Shorina	ショーリナ
Шостаковский
Shostakovsky	ショスタコフスキー	Шостаковская
Shostakovskaya	ショスタコフスカヤ
Шохин
Shokhin	ショーヒン	Шохина
Shokhina	ショーヒナ
Штогрин
Shtogrin	シュトグリン	Штогрина
Shtogrina	シュトグリナ
Шубин
Shubin	シュビン	Шубина
Shubina	シュビナ
Шувалов
Shuvalov	シュヴァロフ	Шувалова
Shuvalova	シュヴァロヴァ
Шуйков
Shuykov	シュイコフ	Шуйкова
Shuykova	シュイコヴァ
Шулепов
Shulepov	シュレポフ	Шулепова
Shulepova	シュレポヴァ
Шульгин
Shulgin	シュリギーン	Шульгина
Shulgina	シュリギーナ
Шурчанов
Shurchanov	シュルチャノフ	Шурчанова
Shurchanova	シュルチャノヴァ
Шурчков
Shurchkov	シュルチコフ	Шурчкова
Shurchkova	シュルチコヴァ
Шутеев
Shuteyev	シュチェエフ	Шутеева
Shuteyeva	シュチェエヴァ
Щапов
Shchapov	シャーポフ、シチャーポフ	Щапова
Shchapova	シャーポヴァ、シチャーポヴァ
Щедрин
Shchedrin	シェドリン、シチェドリン	Щедрина
Shchedrina	シェドリナ、シチェドリナ
Щекочихин
Shchekochikhin	シェコチヒン、シチェコチヒン	Щекочихина
Shchekochikhina	シェコチヒナ、シチェコチヒナ
Щербаков
Shcherbakov	シェルバコフ、シチェルバコフ	Щербакова
Shcherbakova	シェルバコヴァ、シチェルバコヴァ
Щукин
Shchukin	シューキン、シチューキン	Щукина
Shchukina	シューキナ、シチューキナ
Югин
Yugin	ユーギン	Югина
Yugina	ユーギナ
Юдин
Yudin	ユージン	Юдина
Yudina	ユージナ
Южанов
Yuzhanov	ユジャノフ	Южанова
Yuzhanova	ユジャノヴァ
Юков
Yukov	ユーコフ	Юкова
Yukova	ユーコヴァ
Юмашев
Yumashev	ユマーシェフ	Юмашева
Yumasheva	ユマーシェヴァ
Юрков
Yurkov	ユルコフ	Юркова
Yurkova	ユルコヴァ
Юрьев
Yurev	ユリエフ	Юрьева
Yureva	ユリエヴァ
Юсупов
Yusupov	ユスーポフ	Юсупова
Yusupova	ユスーポヴァ
Юсуфов
Yusufov	ユスーフォフ	Юсуфова
Yusufova	ユスーフォヴァ
Юшенков
Yushenkov	ユシェンコフ	Юшенкова
Yushenkova	ユシェンコヴァ
Ющенко
Yushchenko	ユーシェンコ、ユーシチェンコ	Ющенко
Yushchenko	ユーシェンコ、ユーシチェンコ
Яблоков
Yablokov	ヤブロコフ	Яблокова
Yablokova	ヤブロコヴァ
Явлинский
Yavlinsky	ヤヴリンスキー	Явлинская
Yavlinskaya	ヤヴリンスカヤ
Ягудин
Yagudin	ヤグージン（ヤグディン）	Ягудина
Yagudina	ヤグージナ
Якимов
Yakimov	ヤキモフ	Якимова
Yakimova	ヤキモヴァ
Яковенко
Yakovenko	ヤコヴェンコ	Яковенко
Yakovenko	ヤコヴェンコ
Яковлев
Yakovlev	ヤコヴレフ	Яковлева
Yakovleva	ヤコヴレヴァ
Якунин
Yakunin	ヤクーニン	Якунина
Yakunina	ヤクーニナ
Якушев
Yakushev	ヤークシェフ	Якушева
Yakusheva	ヤークシェヴァ
Якушкин
Yakushkin	ヤクーシュキン	Якушкина
Yakushkina	ヤクーシュキナ
Ямкин
Yamkin	ヤムキン	Ямкина
Yamkina	ヤムキナ
Январёв
Yanvaryov	ヤンヴァリョフ	Январёва
Yanvaryova	ヤンヴァリョヴァ
Янковский
Yankovsky	ヤンコフスキー	Янковская
Yankovskaya	ヤンコフスカヤ
Яновский
Yanovsky	ヤノフスキー	Яновская
Yanovskaya	ヤノフスカヤ
Яров
Yarov	ヤーロフ	Ярова
Yarova	ヤーロヴァ
Ярошенко
Yaroshenko	ヤロシェンコ	Ярошенко
Yaroshenko	ヤロシェンコ
Яскунов
Yaskunov	ヤスクノフ	Яскунова
Yaskunova	ヤスクノヴァ
Ястржемский
Yastrzhemsky	ヤストルジェムスキー	Ястржемская
Yastrzhemskaya	ヤストルジェムスカヤ
Яшин
Yashin	ヤーシン	Яшина
Yashina	ヤーシナ