Abayev	アバーエフ
Abakarov	アバカロフ
Abalkin	アバルキン
Abduvaliyev	アブドゥヴァリエフ
Abdulatipov	アブドゥラチポフ
Abdulbasirov	アブドゥルバシロフ
Abdyyev	アブディエフ
Abeltsev	アベリツェフ
Abramenkov	アブラメンコフ
Abramov	アブラモフ
Abrikosov	アブリコーソフ
Abroskin	アブロシキン
Avvakumov	アヴァクモフ
Avdeyev	アヴジェーエフ
Avdeyenko	アヴジェーエンコ
Avdyushin	アヴジュシン
Averin	アヴェリン
Averchev	アヴェルチェフ
Aganbegyan	アガンベギャン
Agapov	アガーポフ
Agafonov	アガフォノフ
Ageyenkov	アゲエンコフ
Agutin	アグーチン
Adamishin	アダミーシン
Adamov	アダモフ
Adrov	アドロフ
Azhayev	アジャーエフ
Azarov	アザーロフ
Akatov	アカトフ
Akbayev	アグバエフ
Akimov	アキモフ
Aksakov	アクサーコフ
Aksyonenko	アクショーネンコ
Aksyonov	アクショーノフ
Akulov	アクロフ
Alaverdov	アラヴェルドフ
Alampiyev	アランピエフ
Alginin	アルギニン
Aldanov	アルダーノフ
Aleksandrov	アレクサンドロフ
Aleksashenko	アレクサシェンコ
Alekseyev	アレクセーエフ
Alyokhin	アリョーヒン
Alyoshin	アリョーシン
Almazov	アルマゾフ
Altukhov	アルトゥーホフ
Albitsky	アリビツキー
Amosov	アモソフ
Ananiyev	アナニエフ
Andreyev	アンドレーエフ
Andropov	アンドロポフ
Anikiyev	アニキエフ
Anisimov	アニシモフ
Anisin	アニシン
Anichkin	アニチキン
Anishev	アニシェフ
Anokhin	アノーヒン
Anpilogov	アンピロゴフ
Antipov	アンチーポフ
Antonenko	アントネンコ
Antonov	アントーノフ
Antropov	アントロポフ
Antufev	アントゥフィエフ
Anufriyev	アヌフリエフ
Arbatov	アルバトフ
Arbuzov	アルブゾフ
Argeyev	アルゲエーフ
Arensky	アレンスキー
Arefev	アレフィエフ
Arzhannikov	アルジャンニコフ
Arinin	アリーニン
Arsenev	アルセーニエフ
Arsky	アルスキー
Artyomov	アルチョモフ
Artemev	アルチェミエフ
Artyukhov	アルチュホフ
Arkhipov	アルヒポフ
Artsybashev	アルツィバーシェフ
Asayev	アサエフ
Askalonov	アスカロノフ
Askerkhanov	アスケルハノフ
Aslamov	アスラモフ
Asmolov	アスモロフ
Asochakov	アソチャコフ
Astapchenko	アスタプチェンコ
Astafev	アスタフィエフ
Astakhov	アスタホフ
Asylmuratov	アスィルムラートフ
Aulov	アウロフ
Afanasev	アファナシエフ
Afanasevsky	アファナシエフスキー
Akhunov	アフーノフ
Ayupov	アユーポフ
Ayatskov	アヤツコフ
Babel	バーベリ
Babenko	バベンコ
Babichev	バビチェフ
Baburin	バブーリン
Bazhov	バジョーフ
Bazarov	バザロフ
Bakunin	バクーニン
Bakusheyev	バクシェエフ
Bakshin	バクシン
Balabin	バラービン
Balakin	バラキン
Balakshin	バラクシン
Balalayev	バララーエフ
Balanev	バラネフ
Barabanov	バラバノフ
Barannikov	バランニコフ
Baranov	バラノフ
Baranovsky	バラノフスキー
Barbashov	バルバショフ
Barsukov	バルスコフ
Barykin	バルィキン
Baryshev	バルィシェフ
Baryshnikov	バルィシュニコフ
Batagayev	バタガエフ
Batanov	バタノフ
Baturin	バトゥーリン
Batyushkin	バチュシュキン
Batsyn	バツィン
Bacherikov	バチェリコフ
Bashmakov	バシュマコフ
Bayunov	バユノフ
Bayandin	バヤンジン
Bevzenko	ベヴゼンコ
Bedarev	ベダレフ、ベーダレフ
Bezborodov	ベズボロドフ
Bezrukov	ベズルコフ
Beketov	ベケトフ
Bekov	ベーコフ
Belashov	ベラショフ
Belevkin	ベレフキン
Belov	ベローフ、ベロフ
Belozerov	ベロゼロフ
Belonogov	ベロノゴフ
Belonosov	ベロノソフ
Belorusov	ベロルソフ
Belousov	ベロウソフ
Belykh	ベルィフ
Beltyukov	ベリチュコフ
Belyayev	ベリャーエフ
Belyakov	ベリャコフ
Berdennikov	ベルジェンニコフ
Berdov	ベルドフ
Berezin	ベレージン
Berezovsky	ベレゾフスキー
Beresnev	ベレスネフ
Besedin	ベセージン
Bespalov	ベスパロフ
Bessarabov	ベッサラーボフ
Beskhmelnitsyn	ベスフメリニツィン
Betin	ベーチン
Beshkarev	ベシュカレフ
Bindyukov	ビンジュコフ
Biryukov	ビリュコフ
Blagovolin	ブラゴヴォリン
Blinnikov	ブリンニコフ
Blinov	ブリノフ
Blokhin	ブロヒーン
Bobkov	ボプコフ
Bobrov	ボブロフ
Bobrovsky	ボブロフスキー
Bobylev	ボブィレフ
Bogatov	ボガトフ
Bogdanov	ボグダーノフ
Boginsky	ボギンスキー
Bogolyubsky	ボゴリュプスキー
Bogomolov	ボゴモロフ
Bodin	ボージン
Bodrov	ボドロフ
Bodryagin	ボドリャギン
Boytsev	ボイツェフ
Bokov	ボーコフ
Bokovikov	ボコヴィコフ
Boldin	ボールジン
Boldyrev	ボールドィレフ、ボルドィレフ
Bolin	ボーリン
Bolotov	ボロトフ
Bolshakov	ボリシャコフ
Bondarev	ボーンダレフ、ボンダレフ
Bondarenko	ボンダレンコ
Bordyuzha	ボルジュジャ
Borisenko	ボリセンコ
Borisov	ボリソフ
Borodayev	ボロダエフ
Borodin	ボロジーン
Borodulin	ボロドゥリン
Borshchyov	ボルショフ、ボルシチョフ
Boskholov	ボスホロフ
Bocharnikov	ボチャルニコフ
Bocharov	ボチャロフ
Bochkaryov	ボチカリョフ
Bragin	ブラーギン
Braginsky	ブラギンスキー
Bratishchev	ブラチーシェフ、ブラチーシチェフ
Bratukhin	ブラトゥヒン
Brudanin	ブルダニン
Brusnitsyn	ブルスニツィン
Bryntsalov	ブルィンツァロフ
Bryukhanov	ブリュハノフ
Bubenin	ブベーニン
Bubyakin	ブビャーキン
Bugayev	ブガエフ
Bugdayev	ブグダエフ
Bugrimov	ブグリモフ
Budazhapov	ブダジャポフ
Buzov	ブーゾフ
Bulavinov	ブラヴィノフ
Bulgakov	ブルガーコフ
Buldayev	ブルダエフ
Bulygin	ブルィギン
Bunin	ブーニン
Bunkov	ブニコフ
Burachenko	ブラチェンコ
Burdukov	ブルドゥコフ
Burdukovsky	ブルドゥコフスキー
Burkov	ブルコフ
Burlakov	ブルラコフ
Burov	ブーロフ
Butenko	ブチェンコ
Butkeyev	ブトケエフ
Butov	ブートフ
Butorin	ブトーリン
Bukhantsev	ブハンツェフ
Buchenkov	ブチェンコフ
Bushmin	ブシュミン
Bushuyev	ブシュエフ
Bykov	ブィコフ
Bystrov	ブィストロフ
Bystryantsev	ブィストリャンツェフ
Bychkov	ブィチコフ
Vavilov	ヴァヴィロフ
Vaganov	ヴァガノフ、ヴァガーノフ
Vaziyev	ヴァジエフ
Vakulenko	ヴァクレンコ
Vakulin	ヴァクリン
Vakunin	ヴァクーニン
Valeyev	ヴァレーエフ
Valov	ヴァロフ
Varennikov	ヴァレンニコフ
Varlamov	ヴァルラモフ
Varnavsky	ヴァルナフスキー
Varov	ヴァロフ
Varukhin	ヴァルーヒン
Vasilev	ヴァシレフ
Vasilevsky	ヴァシレフスキー
Vasilishin	ヴァシリーシン
Vasilev	ヴァシーリエフ
Vasilchenko	ヴァシリチェンコ
Vakhrukov	ヴァフルコフ
Vashchenko	ヴァーシェンコ、ヴァーシチェンコ
Vashchenkov	ヴァーシェンコフ、ヴァーシチェンコフ
Vedernikov	ヴェジェルニコフ
Velikhov	ヴェリホフ
Vengerov	ヴェンゲロフ
Vengerovsky	ヴェンゲロフスキー
Veretennikov	ヴェレチェンニコフ
Vershinin	ヴェルシーニン
Vesyolkin	ヴェショールキン
Veselov	ヴェセローフ
Vecheslov	ヴェチェスロフ
Vechkasov	ヴェチカソフ
Veshnyakov	ヴェシュニャコフ
Vidmanov	ヴィジマノフ
Vikulov	ヴィクロフ
Vilchinsky	ヴィリチンスキー
Vinogradov	ヴィノグラドフ
Vinokurov	ヴィノクロフ
Vitebsky	ヴィチェプスキー
Vishnyov	ヴィシュニョーフ
Vishnevsky	ヴィシュネフスキー
Vishnyakov	ヴィシュニャコフ
Vladimirov	ヴラジーミロフ
Vlasov	ヴラーソフ
Vodorezov	ヴォドレゾフ
Vodyanov	ヴォジャノフ
Voykin	ヴォイキン
Voykov	ヴォイコフ
Voylukov	ヴォイルコフ
Voynov	ヴォイノフ
Volgin	ヴォールギン
Voldorin	ヴォルドリン
Volegov	ヴォレゴフ
Volzhentsev	ヴォルジェンツェフ
Volin	ヴォリン
Volkov	ヴォルコフ
Volkovsky	ヴォルコフスキー
Volkogonov	ヴォルコゴノフ
Volobuyev	ヴォロブエフ
Volodin	ヴォロジン
Volokh	ヴォロフ
Volochkov	ヴォロチコフ
Volyntsev	ヴォルィンツェフ
Volsky	ヴォリスキー
Vorobev	ヴォロビエフ
Vorogushin	ヴォログーシン
Voronin	ヴォローニン
Voronov	ヴォロノフ
Vorontsov	ヴォロンツォフ
Voropayev	ヴォロパーエフ
Vorotnikov	ヴォロトニコフ
Vorfolomeyev	ヴォルフォロメエフ
Voskovetsky	ヴォスコヴェツキー
Vostrotin	ヴォストロチン
Vybornov	ヴィボルノフ
Vylegzhanin	ヴィレグジャーニン
Vyucheysky	ヴィウチェイスキー
Vyalkov	ヴャルコフ
Gaboyev	ガボエフ
Gavrilov	ガヴリーロフ
Gagarin	ガガーリン
Gazeyev	ガゼーエフ
Gaydukov	ガイドゥコフ
Galavteyev	ガラフチェエフ
Galanov	ガラノフ
Galin	ガーリン
Galkin	ガールキン
Galchenko	ガリチェンコ
Gamidov	ガミドフ
Ganibalov	ガニバロフ
Gapeyev	ガペーエフ
Garmashov	ガルマショフ
Garshin	ガールシン
Gachinsky	ガチンスキー
Gayulsky	ガユリスキー
Gvozdaryov	グヴォズダリョフ
Gdlyan	グドリャン
Generalov	ゲネラロフ
Geniatulin	ゲニアトゥリン
Georgiyevsky	ゲオルギエフスキー
Gerasimenko	ゲラシメンコ
Gerasimov	ゲラシモフ
Gerashchenko	ゲラーシェンコ、ゲラーシチェンコ
Gilyarovsky	ギリャロフスキー
Gitin	ギーチン
Gladkov	グラトコフ
Gladsky	グラツキー
Glazovsky	グラゾフスキー
Glazunov	グラズノフ、グラズノーフ
Glazev	グラジエフ
Glotov	グロトフ
Glubokovsky	グルボコフスキー
Glukhovsky	グルホフスキー
Glushenkov	グルシェンコフ
Glushchenko	グルーシェンコ、グルーシチェンコ
Glybin	グルィビン
Gnezdilov	グネズジロフ
Gobolin	ゴボリン
Govorukhin	ゴヴォルーヒン
Gogol	ゴーゴリ
Golov	ゴーロフ
Golovatov	ゴロヴァトフ
Golovachev	ゴロヴァチェフ
Golovin	ゴロヴィン
Golovkin	ゴロフキン
Golovkov	ゴロフコフ
Golovlyov	ゴロヴリョフ
Golubev	ゴールベフ
Golubkov	ゴルプコフ
Golutov	ゴルトフ
Golshebenko	ゴルシェベンコ
Golyshev	ゴルィシェフ
Golbakh	ゴリバフ
Gonzharov	ゴンジャロフ
Goncharenko	ゴンチャレンコ
Goncharov	ゴンチャロフ
Gorbachyov	ゴルバチョフ
Gorbenko	ゴルベンコ
Gorbov	ゴルボフ
Gorbunov	ゴルブノフ
Gordeyev	ゴルジェーエフ
Gorelov	ゴレロフ
Gorlov	ゴルロフ
Gorokholinsky	ゴロホリンスキー
Gorsky	ゴルスキー
Gorshenkov	ゴルシェンコフ
Gorshkov	ゴルシュコフ
Goryunov	ゴリュノフ
Goryachev	ゴリャチェフ
Grazhdankin	グラズダンキン
Granin	グラーニン
Grankin	グランキン
Grachev	グラチェフ
Grebenkin	グレベンキン
Grebennikov	グレベンニコフ
Grekov	グレコフ
Grigorenko	グリゴレンコ
Grigorev	グリゴリエフ
Grin	グリーン
Grinkov	グリニコフ
Gritsayev	グリツァエフ
Grishin	グリーシン
Grishukov	グリシュコフ
Gromov	グロモフ
Gromshikin	グロムシキン
Gromyko	グロムイコ
Gryzunov	グルィズノフ
Gubenko	グベンコ
Gubin	グービン
Guzhvin	グズヴィン
Gukov	グーコフ
Gulidov	グリドフ
Guliyev	グリエフ
Gulyayev	グリャーエフ
Gurevich	グレーヴィチ（グレヴィッチ）
Gurkalov	グルカロフ
Gurov	グーロフ
Gurev	グーリエフ
Gusarov	グサロフ
Gusev	グーセフ
Gustov	グストフ
Guskov	グシコフ
Gutsalov	グツァロフ
Gutseriyev	グツェリエフ
Gushchin	グーシン、グーシチン
Davidenko	ダヴィジェンコ
Davydkin	ダヴィトキン
Davydov	ダヴィドフ
Danilov	ダニロフ
Dankov	ダンコフ
Danchenko	ダンチェンコ
Dvurechensky	ドヴレチェンスキー
Dedegkayev	ジェジェクカエフ
Deynekin	ジェイネーキン
Delidov	ジェリドフ
Delyansky	ジェリャンスキー
Demenkov	ジェメンコフ
Dementev	ジェメーンチェフ
Demidov	ジェミードフ
Dyomin	ジョーミン
Demichev	ジェミチェフ
Demchenko	ジェムチェンコ
Denisov	ジェニソフ
Denisev	ジェニシエフ
Dergachev	ジェルガーチェフ
Deryabin	ジェリャービン
Deryagin	ジェリャーギン
Desyatnikov	ジェシャートニコフ
Desyatov	ジェシャートフ
Detkov	ジェトコフ
Didenko	ジジェンコ
Didichenko	ジジチェンコ
Dmitriyev	ドミトリエフ
Dobzhinsky	ドブジンスキー
Dovlatov	ドヴラートフ
Dogadin	ドガジン
Dogayev	ドガエフ
Dolgov	ドルゴフ
Dolgolaptev	ドルゴラプチェフ
Dolgopolov	ドルゴポロフ
Dolgushin	ドルグーシン
Dorzhiyev	ドルジエフ
Dorovskikh	ドロフスキフ
Doronin	ドローニン
Dorofeyev	ドロフェーエフ
Doroshenko	ドロシェンコ
Dostoyevsky	ドストエフスキー
Dotsenko	ドツェンコ
Draganov	ドラガノフ
Drozdov	ドロズドフ
Drokov	ドロコフ
Drubazhev	ドルバジェフ
Dubinin	ドゥビニン
Dubrovin	ドゥブロヴィン
Dudinsky	ドゥジンスキー
Dumchenko	ドゥムチェンコ
Dunayev	ドゥナエフ
Duryagin	ドゥリャーギン
Dyakov	ジヤコフ
Dyakonov	ジヤコノフ
Dyachenko	ジヤチェンコ
Dyachkov	ジヤチコフ
Dyudyayev	ジュジャエフ
Dyagilev	ジャギレフ
Dyadyuchenko	ジャジュチェンコ
Yevdokimov	エヴドキモフ
Yevstigneyev	エフスチグネーエフ
Yevsyukov	エフシュコフ
Yevteyev	エフチェーエフ
Yevtushenko	エフトゥシェンコ
Yegin	エーギン
Yegorov	エゴロフ
Yelagin	エラーギン
Yelizarov	エリザロフ
Yeliseyev	エリセーエフ
Yelistratov	エリストラートフ
Yeltsin	エリツィン
Yeltsov	エリツォフ
Yelshin	エリシン
Yemelyanov	エメリヤノフ
Yenkov	エニコフ
Yepimakhov	エピマホフ
Yeryomenko	エリョーメンコ
Yeryomin	エリョミン、エリョーミン
Yeryomkin	エリョームキン
Yeremchenko	エリョームチェンコ
Yerin	エーリン
Yermakov	エルマコフ
Yermachenko	エルマチェンコ
Yermolayev	エルモラーエフ
Yermolenko	エルモレンコ
Yerokhin	エローヒン
Yeroshin	エローシン
Yershov	エルショフ
Yefimov	エフィーモフ
Yefremov	エフレモフ
Zhalkovsky	ジャルコフスキー
Zharkov	ジャルコフ
Zharov	ジャロフ
Zhdakayev	ズダカーエフ
Zhdanov	ズダーノフ
Zhdanovsky	ズダノフスキー
Zhebelev	ジェベレフ
Zhebrovsky	ジェブロフスキー
Zheglov	ジェグロフ
Zhekov	ジェコフ
Zherebtsov	ジェレプツォフ
Zhigulin	ジグーリン
Zhidkikh	ジートキフ
Zhilkin	ジルキン
Zhiltsov	ジリツォフ
Zhirinovsky	ジリノフスキー
Zhirkov	ジルコフ
Zhitnikov	ジトニコフ
Zhokin	ジョキン
Zhochkin	ジョチキン
Zhukov	ジューコフ
Zhukovsky	ジュコフスキー
Zhuravkov	ジュラフコフ
Zhuravlyov	ジュラヴリョフ
Zhuravsky	ジュラフスキー
Zhurakovsky	ジュラコフスキー
Zabotkin	ザボトキン
Zavarykin	ザヴァルィキン
Zaveryukha	ザヴェリューハ
Zadonsky	ザドンスキー
Zadornov	ザドルノフ
Zaytsev	ザイツェフ
Zaklinsky	ザクリンスキー
Zamotin	ザモチン
Zamyatin	ザミャーチン
Zapolsky	ザポリスキー
Zaramensky	ザラメンスキー
Zarichansky	ザリチャンスキー
Zaslavsky	ザスラフスキー
Zasukhin	ザスーヒン
Zatulin	ザトゥーリン
Zakharov	ザハロフ
Zvenigorodsky	ズヴェニゴロツキー
Zverev	ズヴェーレフ
Zverkhovsky	ズヴェルホフスキー
Zvolinsky	ズヴォリンスキー
Zvyagin	ズヴャーギン
Zelenin	ゼレーニン
Zelenkin	ゼレンキン
Zelenov	ゼレノフ
Zelensky	ゼレンスキー
Zenkin	ゼンキン
Zerenkov	ゼレンコフ
Zerin	ゼーリン
Zilanov	ジラーノフ
Zimin	ジミーン
Zinovev	ジノヴィエフ
Zlobin	ズロービン
Zolotaryov	ゾロタリョフ
Zolotov	ゾロトフ
Zolotukhin	ゾロトゥーヒン
Zorin	ゾーリン
Zorkaltsev	ゾルカリツェフ
Zotikov	ゾチコフ
Zotin	ゾーチン
Zoshchenko	ゾーシェンコ、ゾーシチェンコ
Zubakin	ズバーキン
Zubakov	ズバコフ
Zubkov	ズプコフ
Zubkovsky	ズプコフスキー
Zubov	ズーボフ
Zuyev	ズーエフ
Zurabov	ズラボフ
Zykov	ズィーコフ
Zyuganov	ジュガノフ
Zyablitsev	ジャブリツェフ
Zyablov	ジャブロフ
Ivakin	イヴァキン
Ivanenko	イヴァネンコ
Ivanov	イヴァノフ（イワノフ）
Ivantayev	イヴァンタエフ
Ivanchenko	イヴァンチェンコ
Ivanyuta	イヴァニュタ
Ivlev	イヴレフ
Ivonin	イヴォニン
Ignatenko	イグナチェンコ
Ignatkov	イグナトコフ
Ignatov	イグナートフ
Ignatev	イグナーチェフ
Igrunov	イグルノフ
Igumnov	イグムノフ
Iyevlev	イエヴレフ
Ikonnikov	イコンニコフ
Illarionov	イッラリオーノフ
Ilovsky	イロフスキー
Ilenkov	イリエンコフ
Ilyin	イリイーン
Ilyinsky	イリインスキー
Ilyichev	イリイチェフ
Ilyushenko	イリユシェンコ
Ilyukhin	イリューヒン
Ilyushechkin	イリュシェチキン
Ilyushin	イリューシン
Imedoyev	イメドエフ
Ionov	イオーノフ
Ippolitov	イッポリートフ
Isayev	イサエフ
Isakov	イサコフ
Ispravnikov	イスプラーヴニコフ
Ishayev	イシャエフ
Ishchenko	イーシェンコ、イーシチェンコ
Kabayev	カバエフ
Kabakov	カバコフ
Kabanov	カバノフ
Kaverin	カヴェーリン
Kagalovsky	カガロフスキー
Kadannikov	カダンニコフ
Kadochnikov	カドチニコフ、カードチニコフ
Kazakov	カザコフ
Kazakovtsev	カザコフツェフ
Kazantsev	カザンツェフ
Kazarov	カザロフ
Kazmin	カジミン
Kalandin	カランジン
Kalatozov	カラトーゾフ
Kalashnikov	カラーシュニコフ（カラシニコフ）
Kalin	カーリン
Kalinin	カリーニン
Kalistratov	カリストラトフ
Kalmykov	カルムイコフ
Kalyagin	カリャーギン
Kamenev	カメネフ
Kaminsky	カミンスキー
Kamyshinsky	カムイシンスキー
Kanayev	カナーエフ
Kandakov	カンダコフ
Kandinsky	カンジンスキー（カンディンスキー）
Kantemirov	カンチェミロフ
Kapustin	カプスチン
Karaganov	カラガノフ
Karamzin	カラムジン
Karasin	カラシン
Karastin	カラスチン
Karachurin	カラチュリン
Karbovsky	カルボフスキー
Karganov	カルガノフ
Karev	カーレフ
Karelin	カレーリン
Karimov	カリモフ
Karlov	カルロフ
Karnaukh	カルナウフ
Karnaukhov	カルナウホフ
Karpov	カルポフ
Karsavin	カルサーヴィン
Kartashov	カルタショフ
Karyakin	カリャキン
Kasymov	カスィモフ
Kasyanov	カシヤノフ
Katayev	カターエフ
Katalnikov	カタリニコフ
Katanandov	カタナンドフ
Katrenko	カトレンコ
Katulsky	カトゥリスキー
Kaurov	カウロフ
Katsalapov	カツァラポフ
Kachanov	カチャノフ
Kachimov	カチモフ
Kashpirovsky	カシュピローフスキー
Kvasov	クヴァソフ
Kvashnin	クヴァシュニン
Kedrovsky	ケドロフスキー
Kekishev	ケキシェフ
Kechkin	ケチキン
Kiberiyev	キベリエフ
Kibirev	キービレフ
Kireninov	キレニノフ
Kiriyenko	キリエンコ
Kirilichev	キリリチェフ
Kirillov	キリーロフ
Kirichenko	キリチェンコ
Kirpichnikov	キルピチニコフ
Kiryakov	キリヤコフ
Kiselyov	キセリョフ
Kisin	キーシン
Kislitsyn	キスリツィン
Klevtsov	クレフツォフ
Klimenko	クリメンコ
Klimov	クリモフ
Klinov	クリノフ
Klochkov	クロチコフ
Klyuchnikov	クリュチニコフ
Knyazhev	クニャジェフ
Knyazev	クニャーゼフ
Kobelev	コベレフ
Kobylkin	コブィルキン、コビルキン
Kovalyov	コヴァリョフ
Kovalevsky	コヴァレフスキー
Kovalenko	コヴァレンコ
Kovalsky	コヴァリスキー
Kovrizhnykh	コヴリーズヌィフ
Kozhevnikov	コジェヴニコフ
Kozhemyakin	コジェミャキン
Kozhokin	コジョーキン
Kozhukhov	コジュホフ
Kozeradsky	コゼラツキー
Kozlov	コズロフ
Kozyrev	コーズィレフ
Kokov	コーコフ
Kokorev	コーコレフ
Kokoshin	ココーシン
Kolbasov	コルバソフ
Kolganov	コルガノフ
Kolegov	コーレゴフ
Kolesnikov	コレスニコフ
Kolesnichenko	コレスニチェンコ
Kolinichenko	コリニチェンコ
Kolmakov	コルマコフ
Kolobov	コーロボフ
Kologolov	コロゴロフ
Kolodeznikov	コロジェズニコフ
Kolokolov	コロコロフ
Kolomeytsev	コロメイツェフ
Kolomenkin	コロメンキン
Kolosov	コロソフ
Kolpakov	コルパコフ
Koltakov	コルタコフ
Komarov	コマロフ
Komarovsky	コマロフスキー
Komissarov	コミッサーロフ
Komlev	コムレフ
Komov	コーモフ
Kompantsev	コンパンツェフ
Komchatov	コムチャトフ
Konakov	コナコフ
Kondakov	コンダコフ
Kondaurov	コンダウロフ
Kondratenko	コンドラチェンコ
Kondratov	コンドラトフ
Kondratev	コンドラーチェフ
Kondrashov	コンドラショフ
Konovalov	コノヴァロフ
Kononov	コーノノフ
Konstantinov	コンスタンチノフ
Konchalovsky	コンチャロフスキー
Kopeykin	コペイキン
Kopsov	コプソフ
Koptev	コプチェフ
Kopylov	コプィロフ
Korabelshchikov	コラベリシコフ、コラベリシチコフ
Korelsky	コレリスキー
Korepanov	コレパノフ
Korzhakov	コルジャコフ
Korniyenko	コルニエンコ
Kornilov	コルニーロフ
Korobeynikov	コロベイニコフ
Korobitsin	コロビツィン
Korobka	コロープカ
Korobov	コロボフ
Korobchenko	コロプチェンコ
Korovkin	コロフキン
Korovnikov	コロヴニコフ
Korolyov	コロリョーフ
Korolenko	コロレンコ
Korotkov	コロトコフ
Korochin	コロチン
Korpachev	コルパチェフ
Korsakov	コルサコフ
Korsun	コルスン
Korsunov	コルスノフ
Korsuntsev	コルスンツェフ
Korchagin	コルチャーギン
Korshunov	コルシュノフ
Kosarikov	コサリコフ
Kosenko	コセンコ
Kosikov	コシコフ
Kosopkin	コソプキン
Kossov	コッソフ
Kostenko	コスチェンコ
Kosterin	コスチェリン
Kostikov	コスチコフ
Kostin	コスチン
Kostomarov	コストマロフ
Kostyrin	コストィリン
Kostyunin	コスチュニン
Kostyutkin	コスチュトキン
Kostyuchenko	コスチュチェンコ
Kosykh	コスィフ
Kotelkin	コチェルキン
Kotenyov	コチェニョーフ
Kotenkov	コチェンコフ
Kotkov	コトコフ
Kotlyarov	コトリャロフ
Kotov	コートフ、コトフ
Kotyusov	コチュソフ
Kochegura	コチェグラ
Kochergin	コチェルギン
Koshelev	コーシェレフ
Koshkin	コシュキン、コーシュキン
Kravtsov	クラフツォフ
Kraynev	クライネフ
Krapivin	クラピヴィン
Krasavchenko	クラサフチェンコ
Krasikov	クラシコフ
Krasilnikov	クラシーリニコフ
Krasnikov	クラスニコフ
Krasnov	クラスノフ
Krasnopivtsev	クラスノピフツェフ
Krasnoyarov	クラスノヤロフ
Krasnykh	クラスヌィフ
Krasheninnikov	クラシェニンニコフ
Krestyaninov	クレスチヤニノフ
Krivelyov	クリヴェリョフ
Krivov	クリヴォフ
Krivoshapkin	クリヴォシャプキン
Krivchenko	クリフチェンコ
Kropotkin	クロポトキン
Kropotov	クロポトフ
Kruglikov	クルグリコフ
Kruglov	クルグロフ
Krupnov	クルプノフ
Krutykh	クルトィフ
Krushinsky	クルシンスキー
Krylov	クルィロフ
Krysyayev	クルィシャエフ
Kryukov	クリューコフ
Kryuchkov	クリュチコフ
Kubarev	クーバレフ
Kuvayev	クヴァエフ
Kuvshinov	クフシノフ
Kudinov	クジノフ
Kudrin	クドリン
Kudryavtsev	クドリャーフツェフ
Kudryashov	クドリャショーフ
Kuzenkov	クゼンコフ
Kuzin	クージン
Kuzmin	クズミン
Kuznetsov	クズネツォフ
Kuznechov	クズネチョフ
Kuzmin	クジミン
Kuzmichev	クジミチェフ
Kuzyukov	クジュコフ
Kulagin	クラーギン
Kulakov	クラコーフ
Kulakovsky	クラコフスキー
Kulyomin	クリョーミン
Kuleshev	クレシェフ
Kulikov	クリコフ
Kulechev	クリエチェフ
Kunin	クーニン
Kuprin	クプリーン、クプリン
Kupriyanovsky	クプリヤノフスキー
Kuptsov	クプツォフ
Kurakov	クラコフ
Kuramin	クラミン
Kuranov	クラノフ
Kurbatov	クルバトフ
Kurgapkin	クルガープキン
Kurenkov	クレンコフ
Kurin	クーリン
Kuritsyn	クリツィン
Kurnikov	クルニコフ
Kuropatkin	クロパトキン
Kurochkin	クロチキン
Kurtin	クルチン
Kutafin	クタフィン
Kutukov	クトゥコフ
Kuchinsky	クチンスキー
Kshesinsky	クシェシンスキー
Lavrentev	ラヴレーンチェフ
Lavrov	ラヴローフ
Lavrovsky	ラヴロフスキー
Ladygin	ラドィギン
Lazarev	ラーザレフ、ラザレフ
Lazarenko	ラザレンコ
Lazutkin	ラズトキン
Lapin	ラーピン
Laptev	ラプチェフ
Lapshin	ラプシン
Larionov	ラリオノフ
Latkin	ラトキン
Latyshev	ラートィシェフ
Lebedev	レベジェフ
Levashov	レヴァショフ
Levedev	レヴェジェフ
Levitan	レヴィタン
Levkov	レフコフ
Levchenko	レフチェンコ
Legkov	レクコフ
Lednev	レドネフ
Lezhnin	レズニン
Lemeshev	レメシェフ
Lemeshov	レメショフ
Leonov	レオーノフ、レオノフ
Leontev	レオーンチェフ
Leonchev	レオンチェフ
Lepyokhin	レピョーヒン
Leskin	レスキン
Leskov	レスコフ
Leushkin	レウシュキン
Livanov	リヴァノフ
Livinsky	リヴィンスキー
Ligachyov	リガチョフ
Limansky	リマンスキー
Lipnitsky	リプニツキー
Lisin	リーシン
Lisitsyn	リシツィン
Lisichkin	リシチキン
Litvinenko	リトヴィネンコ
Litvinov	リトヴィノフ
Litvintsev	リトヴィンツェフ
Liforov	リフォロフ
Likhachyov	リハチョフ
Lichenko	リチェンコ
Lobanov	ロバーノフ
Lobkov	ロプコフ
Lobov	ローボフ
Lobukhin	ロブーヒン
Lobyshev	ロブィシェフ
Loginov	ロギノフ
Logunenko	ログネンコ
Logunov	ログノフ
Lodkin	ロトキン
Lozov	ローゾフ
Loktionov	ロクチオノフ
Lomakin	ロマキン
Lopatikin	ロパチキン
Lopatin	ロパーチン
Lopatkin	ロパートキン
Lopukhov	ロプホフ
Losev	ローセフ
Lotkov	ロトコフ
Lubenchenko	ルベンチェンコ
Luzhkov	ルシュコフ
Lukashyov	ルカショフ
Lukin	ルキーン
Lukyanov	ルキヤノフ
Lunyov	ルニョフ
Luntovsky	ルントフスキー
Luchagin	ルチャギン
Lyzhin	ルィジン
Lysenko	ルィセンコ
Lysov	ルィソフ
Lytkin	ルィートキン
Lyubimov	リュビーモフ
Lyublin	リュブリン
Lyutov	リュトフ
Lyakhov	リャホフ
Lyashchevsky	リャシェフスキー、リャシチェフスキー
Magin	マギン
Magomedov	マゴメドフ
Mazayev	マザエフ
Mayorov	マイヨーロフ
Maytakov	マイタコフ
Makagonov	マカゴノフ
Makarenko	マカレンコ
Makarentsev	マカレンツェフ
Makarov	マカロフ
Makashov	マカショフ
Makoveyev	マコヴェエフ
Maksakov	マクサコフ
Maksimenko	マクシメンコ
Maksimov	マクシモフ
Maksimtsev	マクシムツェフ
Maleyev	マレーエフ
Malkin	マルキン
Malov	マロフ
Malykhin	マルィヒン
Malyshev	マルィシェフ
Malkov	マリコフ
Maltsev	マリツェフ
Mamedov	マメドフ
Mamleyev	マムレーエフ
Mamontov	マーモントフ
Manayenkov	マナエンコフ
Manannikov	マナンニコフ
Mandrygin	マンドルィギン
Manezhev	マネジェフ
Manzhosov	マンジョソフ
Manilov	マニロフ
Manokhin	マノヒン
Manoshkin	マノシュキン
Manyakin	マニャーキン
Markelov	マルケロフ
Markidonov	マルキドノフ
Markov	マルコフ
Markovsky	マルコフスキー
Markomenko	マルコメンコ
Martemyanov	マルチェミヤーノフ
Martynenko	マルトィネンコ
Martynov	マルトィノフ
Martyanov	マルチヤノフ
Marchenko	マルチェンコ
Marshev	マルシェフ
Marychev	マルィチェフ
Maskayev	マスカエフ
Maslov	マスロフ
Maslovsky	マスロフスキー
Maslyukov	マスリュコフ
Mastafov	マスタフォフ
Matveyev	マトヴェーエフ
Matviyenko	マトヴィエンコ
Materov	マチェロフ
Matochkin	マトチキン
Matyunin	マチュニン
Matyukhin	マチュヒン
Matyushov	マチュショフ
Matyashov	マチャショフ
Makhalin	マハーリン
Makhanov	マハノフ
Mashevsky	マシェフスキー
Mashinsky	マシンスキー
Mashkov	マシュコフ、マシュコーフ
Mashkovtsev	マシュコーフツェフ
Medvedev	メドヴェージェフ（メドベージェフ）
Medentsov	メジェンツォフ
Medikov	メジコフ
Mezentsev	メゼンツェフ
Melentev	メレンチェフ
Melekh	メレフ
Melikyan	メリキヤン
Melkov	メリコフ
Melnikov	メリニコフ
Melnichenko	メリニチェンコ
Menshikov	メニシコフ
Menshov	メニショフ
Menshchikov	メーニシコフ、メーニシチコフ
Meremyanin	メレミャーニン
Merkulov	メルクロフ
Merkushev	メルクシェフ
Merkushin	メルクーシン
Mertsalov	メルツァロフ
Meskov	メシコフ
Metelev	メチェレフ
Meshalkin	メシャルキン
Meshcheryakov	メシェリャコフ、メシチェリャコフ
Migranyan	ミグラニャン
Migunov	ミグノフ
Miklin	ミクリン
Mikoyan	ミコヤン
Milov	ミロフ
Minakov	ミナコフ
Mironenko	ミロネンコ
Mironov	ミロノフ
Miskov	ミシコフ
Mitin	ミーチン
Mitrofanov	ミトロファノフ
Mitrokhin	ミトロヒン
Mityukov	ミチュコフ
Mityayev	ミチャーエフ
Mikhaylov	ミハイロフ
Mikhalyov	ミハリョフ
Mikhalkov	ミハルコフ
Mikheyev	ミヘーエフ
Mishin	ミーシン
Mishchenkov	ミシェンコフ、ミシチェンコフ
Modnov	モドノフ
Moiseyev	モイセーエフ
Moiseyenko	モイセーエンコ
Mokrousov	モクロウソフ
Molostvov	モロストヴォフ
Molotkov	モロトコフ
Molotov	モロトフ
Molochkov	モロチコフ
Molchanov	モルチャノフ
Molyarenko	モリャレンコ
Monastyrsky	モナストィルスキー
Monisov	モニソフ
Morgun	モルグン
Morozov	モロゾフ
Morokin	モロキン
Moskvichyov	モスクヴィチョフ
Moskovsky	モスコフスキー
Mostovoy	モストヴォイ
Moshenko	モシェンコ
Moshkin	モーシュキン
Moshchenkov	モシェンコフ、モシチェンコフ
Muzykantsky	ムズィカンツキー
Mukusev	ムクセフ
Muravyov	ムラヴィヨフ
Muranov	ムラノフ
Muratov	ムラトフ
Murashev	ムラシェフ
Musatov	ムサトフ
Mutkov	ムトコフ
Mukhametshin	ムハメトシン
Mukhin	ムーヒン
Mytakov	ムイタコフ
Myasnikov	ミャスニコーフ
Nabokov	ナボコフ
Nazheyn	ナジェイン
Nazarenko	ナザレンコ
Nazarov	ナザロフ
Nazdratenko	ナズドラチェンコ
Napolov	ナポロフ
Narolin	ナロリン
Nasinovsky	ナシノフスキー
Natalenko	ナタレンコ
Natapov	ナタポフ
Naumov	ナウモフ
Nevzorov	ネヴゾロフ
Nedelin	ネジェーリン
Neyolov	ネヨーロフ
Nekrasov	ネクラーソフ
Nekrutenko	ネクルチェンコ
Nelasov	ネラソフ
Nemtsov	ネムツォフ
Neskoblinov	ネスコブリノフ
Nesterenko	ネスチェレンコ、ネステレンコ
Nesterov	ネスチェロフ、ネステロフ
Neuymin	ネウイミン
Nechayev	ネチャエフ
Nizhinsky	ニジンスキー
Nikandrov	ニカンドロフ
Nikanorov	ニカノロフ
Nikitenko	ニキーチェンコ
Nikitin	ニキーチン
Nikitov	ニキートフ
Nikiforenko	ニキフォレンコ
Nikiforov	ニキフォロフ
Nikolayev	ニコラエフ
Nikologorsky	ニコロゴルスキー
Nikolsky	ニコリスキー
Nikonov	ニコノフ
Nikotin	ニコチン
Nikulenko	ニクレンコ
Nikulin	ニクーリン
Nimayev	ニマエフ
Novikov	ノヴィコフ
Novoselov	ノヴォセロフ
Novoseltsov	ノヴォセリツォフ
Nozhikov	ノジコフ
Noskov	ノスコーフ
Nosov	ノーソフ
Nuykin	ヌイキン
Nureyev	ヌレーエフ
Oblasov	オブラソフ
Obukhov	オブホフ
Ovsyannikov	オフシャーンニコフ
Ovcharov	オフチャロフ
Ovchenkov	オフチェンコフ
Ovchinnikov	オフチーンニコフ
Ogorodnikov	オゴロドニコフ
Ogurtsov	オグルツォフ
Odintsov	オジンツォフ
Ozerov	オゼロフ
Okatov	オカトフ
Olkhovikov	オリホヴィコフ
Onishchenko	オニーシェンコ、オニーシチェンコ
Onopriyenko	オノプリエンコ
Openyshev	オペヌィシェフ
Orekhov	オレーホフ
Orlov	オルロフ
Orlovsky	オルロフスキー
Osadchikh	オサトチフ
Osipenko	オシペンコ
Osipov	オシポフ
Osminin	オスミニン
Osmolkin	オスモルキン
Osovtsov	オソフツォフ
Ostrovsky	オストロフスキー
Ostroumov	オストロウモフ
Pavlenko	パヴレンコ
Pavlichenko	パヴリチェンコ
Pavlov	パヴロフ
Pavlukhin	パヴルヒン
Paleyev	パレーエフ
Panarin	パナーリン
Pankin	パンキン、パーンキン
Pankratenko	パンクラチェンコ
Panov	パノーフ、パノフ
Panskov	パンスコフ
Panfyorov	パンフョーロフ
Panfilov	パンフィロフ
Pankin	パニキン
Paramonov	パラモノフ
Parin	パーリン
Parinov	パリノフ
Parfyonov	パルフョーノフ
Parkhomenko	パルホメンコ
Parshakov	パルシャコフ
Pastukhov	パストゥホフ
Patanov	パタノフ
Patrushev	パトルシェフ
Pakhomov	パホモフ
Pashin	パーシン
Pashkov	パシュコフ
Pashchenko	パーシェンコ、パーシチェンコ
Peganov	ペガノフ
Pekarsky	ペカルスキー
Pelevin	ペレーヴィン
Pestov	ペーストフ
Petoshin	ペトシン
Petrakov	ペトラコフ
Petrenko	ペトレンコ
Petrishchev	ペトリーシェフ、ペトリーシチェフ
Petrov	ペトロフ
Petrovsky	ペトロフスキー
Petrushkin	ペトルーシュキン
Petukhov	ペトゥホーフ
Pechenkin	ペチェンキン
Peshkov	ペシュコフ
Pivovarov	ピヴォヴァロフ
Pimenov	ピーメノフ、ピメノフ
Pirogov	ピロゴフ
Pisarenko	ピサレンコ
Pisknov	ピスクノフ
Piskun	ピスクン、ピスクーン
Platov	プラートフ、プラトフ
Platonov	プラトーノフ
Pletnyov	プレトニョフ
Plotnikov	プロトニコフ
Plyushchenko	プリューシェンコ、プリューシチェンコ（プルシェンコ）
Podberyozkin	ポドベリョスキン
Podgornov	ポドゴルノフ
Podufalov	ポドゥファロフ
Podchufarov	ポトチュファロフ
Pozhitkov	ポジトコフ
Pozgalyov	ポズガーリョフ
Pozdnyakov	ポズニャコフ
Pokrovsky	ポクロフスキー
Poldnikov	ポルドニコフ
Polevanov	ポレヴァノフ
Polezhayev	ポレジャエフ
Polivanov	ポリヴァノフ
Politkovsky	ポリトコフスキー
Polozkov	ポロスコフ
Polonsky	ポロンスキー
Polosin	ポローシン
Poltavtsev	ポルタフツェフ
Poltoranin	ポルトラーニン
Polunin	ポルーニン
Polupanov	ポルパノフ
Poluyanov	ポルヤノフ
Polyakov	ポリャコフ
Pomorov	ポモーロフ
Ponamarenko	ポナマレンコ
Ponasov	ポナソフ
Ponomaryov	ポノマリョフ
Ponomarenko	ポノマレンコ
Popov	ポポーフ、ポポフ
Portnov	ポルトノフ
Poryadin	ポリャジン
Potanin	ポターニン
Potapenko	ポタペンコ
Potapov	ポターポフ、ポタポフ
Potyomkin	ポチョムキン
Potolitsyn	ポトリツィン
Pokhmelkin	ポフメルキン
Pocherevin	ポチェレヴィン
Preobrazhensky	プレオブラジェンスキー
Przhezdomsky	プルジェズドムスキー
Primakov	プリマコフ
Pristavkin	プリスタフキン
Prokopenko	プロコペンコ
Prokopev	プロコピエフ
Prokudin	プロクージン
Pronin	プローニン
Prosvirnov	プロスヴィルノフ
Proskuryakov	プロスクリャコフ
Protkopov	プロトコポフ
Prokhorov	プロホロフ
Protsenko	プロツェンコ
Proshin	プロシン
Pryamukhin	プリャムヒン
Pugachyov	プガチョフ
Puzanovsky	プザノフスキー
Putilov	プチロフ
Putin	プーチン
Pushkaryov	プシュカリョフ
Pushkin	プーシュキン（プーシキン）
Pchyolkin	プチョールキン
Pylnev	プィリネフ
Rabdanov	ラブダノフ
Rabotyazhev	ラボチャジェフ
Radzinsky	ラジンスキー
Radulov	ラドゥロフ
Razhev	ラジェフ
Razdukhov	ラズドゥホフ
Razimov	ラジモフ
Raykov	ライコフ
Rakitov	ラキトフ
Rakov	ラーコフ、ラコフ
Rasputin	ラスプーチン
Rassolov	ラッソロフ
Rassokhin	ラッソヒン
Rastorguyev	ラストルグエフ
Rakhmanin	ラフマニン
Rachyov	ラチョフ
Redkin	レチキン
Rezaykin	レザイキン
Renov	レノフ
Repin	レーピン
Repkin	レプキン
Resin	レーシン
Reshetnikov	レシェートニコフ
Reshulsky	レシュリスキー
Rogachyov	ロガチョフ
Rogov	ローゴフ
Rogovsky	ロゴフスキー
Rodin	ロージン
Rodionov	ロジオノフ
Rodnin	ロドニン
Rodchenko	ロトチェンコ
Rozhkov	ロシュコフ、ロシュコーフ
Romanenko	ロマネンコ
Romanov	ロマノフ
Romanovsky	ロマノフスキー
Romashkin	ロマーシュキン
Rokhlin	ロフリン
Roshchin	ローシン、ローシチン
Rubanov	ルバノフ
Rudnikov	ルドニコフ
Ruzhkov	ルシュコフ
Ruzimatov	ルジマートフ
Rumyantsev	ルミャンツェフ
Runov	ルノフ
Rupasov	ルパソフ
Rusakov	ルサコーフ
Rusin	ルーシン、ルシーン
Rusinov	ルシーノフ
Rutkovsky	ルトコフスキー
Rybakov	ルィバコフ
Rybalkin	ルィバルキン
Rybkin	ルィプキン
Rygalov	ルィガロフ
Ryzhkov	ルィシュコフ
Ryzhov	ルィジョフ
Ryzhonkov	ルィジョンコフ
Ryndovsky	ルィンドフスキー
Ryurikov	リュリコフ
Ryabev	リャベフ
Ryabenko	リャベンコ
Ryabinsky	リャビンスキー
Ryabov	リャボフ
Ryabukhin	リャブヒン
Ryazanov	リャザノフ
Sablin	サブリン
Saburov	サブロフ
Savelev	サヴェリエフ
Savin	サヴィン
Savinkov	サーヴィンコフ
Savitsky	サヴィツキー
Savostin	サヴォスチン
Savostyanov	サヴォスチヤノフ
Savchenko	サフチェンコ
Saganov	サガノフ
Sadomsky	サドムスキー
Sadchikov	サッチコフ
Sayenko	サエンコ
Sazhinov	サジノフ
Sazonov	サゾノフ
Saitov	サイートフ
Sayfullin	サイフーリン
Salmin	サルミン
Salov	サーロフ
Saltykov	サルトィコフ
Salnikov	サリニコフ
Samarin	サマリン
Samoylov	サモイロフ
Samsonov	サムソノフ
Samusev	サムセフ
Sanayev	サナエフ
Sanzharov	サンジャロフ
Sapovsky	サポフスキー
Sapozhnikov	サポーズニコフ
Sarayev	サラエフ
Sarafanov	サラファノフ
Sarychev	サルィチェフ
Satarov	サタロフ
Saunin	サウニン
Safonov	サフォノフ
Safronov	サフロノフ
Sakharov	サハロフ
Sakhnovsky	サフノフスキー
Svetkin	スヴェトキン
Svechnikov	スヴェチニコフ
Svinarenko	スヴィナレンコ
Svinin	スヴィーニン
Sebentsov	セベンツォフ
Sevastyanov	セヴァスチヤーノフ
Sevryugin	セヴリューギン
Sedov	セドフ
Sedykh	セドィフ
Seleznyov	セレズニョフ
Selivanov	セリヴァノフ
Seliverstov	セリヴェルストフ
Selyunin	セリューニン
Selyutin	セリュチン
Selyutsky	セリュツキー
Semyonov	セミョーノフ
Semenchenko	セメンチェンコ
Semernyov	セメルニョフ
Semukov	セムコフ
Senatorov	セナトロフ
Senin	セーニン
Sennikov	センニコフ
Sergeyev	セルゲーエフ
Sergeyenkov	セルゲエンコフ
Sergiyenko	セルギエンコ
Serdyukov	セルジュコフ
Serebryakov	セレブリャコフ
Seryogin	セリョーギン
Serov	セロフ
Seryakov	セリャコフ
Seslavinsky	セスラヴィンスキー
Sigarev	シーガレフ
Sidelnikov	シジェリニコフ
Sidenko	シジェンコ
Sidorenko	シドレンコ
Sidorov	シードロフ
Sizov	シゾフ
Silin	シーリン
Simakov	シマコフ
Simakhin	シマヒン
Simonov	シーモノフ
Sinitsyn	シニツィン
Sirenko	シレンコ
Sirotenko	シロチェンコ
Sirotkin	シロトキン
Sitnikov	シトニコフ
Skachkov	スカチコフ
Skvortsov	スクヴォルツォフ
Sklyarov	スクリャロフ
Skokov	スコーコフ
Skopovsky	スコポフスキー
Skorokhodov	スコロホドフ
Skorochkin	スコロチキン
Skripov	スクリポフ
Skripchenko	スクリプチェンコ
Skryabin	スクリャービン
Skurikhin	スクリーヒン
Slezkin	スレスキン
Sleptsov	スレプツォフ
Slutsky	スルツキー
Smagin	スマーギン
Smekalov	スメカロフ
Smetankin	スメタンキン
Smirnov	スミルノフ
Smirnyagin	スミルニャギン
Smolentsev	スモレンツェフ
Smolin	スモーリン
Smolyakov	スモリャコフ
Snezhkov	スネシュコフ
Sobakin	ソバキン
Sobolev	ソボレフ
Sobyanin	ソビャニン
Sokolin	ソコリン
Sokolov	ソコロフ
Solzhenitsyn	ソルジェニーツィン
Solkin	ソルキン
Solovov	ソロヴォフ
Solovyov	ソロヴィヨフ
Solovyanov	ソロヴィヤノフ
Solomatin	ソロマチン
Solomatkin	ソロマトキン
Solomov	ソロモフ
Soluyanov	ソルヤノフ
Somov	ソーモフ、ソモフ
Sorokin	ソローキン
Sotnikov	ソトニコフ
Sokhov	ソホフ
Sochilin	ソチリン
Spesivtsev	スペシフツェフ
Spiridonov	スピリドノフ
Starikov	スタリコフ
Starovoytov	スタロヴォイトフ
Starodubov	スタロドゥボフ
Starodubtsev	スタロドゥプツェフ
Starostin	スタロスチン
Starchukov	スタルチュコフ
Starygin	スタルィギン
Stepanenko	スチェパネンコ、ステパネンコ
Stepankov	スチェパンコフ
Stepanov	スチェパノフ
Stepashin	スチェパーシン
Sterligov	スチェルリゴフ
Stifunin	スチフーニン
Stolbov	ストルボフ
Stolypin	ストルィピン、ストルイピン
Stolyarov	ストリャロフ
Storozhenko	ストロジェンコ
Strakhov	ストラホフ
Strelkov	ストレルコフ
Strigin	ストリギン
Stroyev	ストロエフ
Strugov	ストルゴフ
Strygin	ストルィギン
Stukalsky	ストゥカリスキー
Stupnikov	ストゥプニコフ
Sturov	ストゥロフ
Subbotin	スッボーチン
Suvorinov	スヴォリノフ
Suvorov	スヴォロフ
Sudarenkov	スダレンコフ
Sudenkov	スジェンコフ
Sulakshin	スラクシン
Sumarokov	スマロコフ
Suraykin	スライキン
Surganov	スルガノフ
Surenkov	スレンコフ
Surzhikov	スルジコフ
Surikov	スリコフ
Surkov	スルコフ
Surov	スーロフ
Suslov	スースロフ
Suturin	ストゥーリン
Sukhanov	スハノフ
Sukhov	スーホフ
Sysoyev	スィソエフ
Sysuyev	スィスエフ
Sychyov	スィチョフ、シチョフ
Syutkin	シュトキン
Tabayev	タバエフ
Tabolin	タボリン
Talanov	タラノフ
Tarantsov	タランツォフ
Tarasenko	タラセンコ
Tarasov	タラソフ
Tarachev	タラチェフ
Tarkovsky	タルコフスキー
Tataurov	タタウロフ
Tatkov	タトコフ
Telyatnikov	チェリャトニコフ
Temirzhanov	チェミルジャノフ
Terentev	チェレンチェフ
Terekhov	チェレホフ
Teryoshkin	チェリョーシュキン
Tereshkov	チェレシュコフ
Tereshchenko	チェレーシェンコ、チェレーシチェンコ
Tetelmin	チェチェリミン
Teterin	チェチェリン
Timofeyev	チモフェーエフ
Timoshenko	チモシェンコ
Titenko	チチェンコ
Titkin	チトキン
Titov	チトーフ
Tikhomirov	チホミロフ
Tikhonov	チーホノフ
Tkachyov	トカチョフ
Tkachenko	トカチェンコ
Tokarev	トーカレフ、トカレフ
Tokulenko	トクレンコ
Tolkachyov	トルカチョフ
Tolmachyov	トルマチョフ
Tolstoy	トルストイ
Tolstoshein	トルストシェイン
Tomtosov	トムトソフ
Tomchin	トムチン
Toporkov	トポルコフ
Toporov	トポロフ
Torbin	トルビン
Torlopov	トルロポフ
Toropov	トロポフ
Torkhov	トルホフ
Torshin	トルシン
Totiyev	トチーエフ
Travkin	トラフキン
Travnikov	トラヴニコフ
Traspov	トラスポフ
Tregubov	トレグボフ
Tretyakov	トレチヤコーフ
Trefilov	トレフィロフ
Tropin	トロピン
Trofimov	トロフィモフ
Trotsky	トロツキー
Troshin	トローシン
Troshkin	トロシュキン
Trubnikov	トルブニコフ
Trushnikov	トルシュニコフ
Tubylov	トゥブィロフ
Tuinov	トゥイノフ
Tuktamyshev	トゥクタムイシェフ
Tumanov	トゥマーノフ
Turbanov	トゥルバノフ
Turbin	トゥルビン
Turgenev	トゥルゲーネフ（ツルゲーネフ）
Turov	トゥーロフ
Turusin	トゥルシン
Tuchkov	トゥチコフ
Tyuneyev	チュネーエフ
Tyagachev	チャガチェフ
Tyagunov	チャグノフ
Tyazhlov	チャズロフ
Uvarov	ウヴァーロフ
Uvachan	ウヴァチャン
Udovenko	ウドヴェンコ
Ulanov	ウラノフ、ウラーノフ
Ulitsky	ウリツキー
Ulybin	ウルィビン
Ulyanov	ウリヤノフ
Urinson	ウリンソン
Urmanov	ウルマーノフ
Urnov	ウルノフ
Uryvin	ウルィヴィン
Usachev	ウサーチェフ
Usov	ウーソフ
Uspensky	ウスペンスキー
Ustinov	ウスチノフ
Ustyugov	ウスチュゴフ
Utkin	ウトキン
Ukhanev	ウハネフ
Ushakov	ウシャコフ
Fadeyev	ファジェーエフ
Falaleyev	ファラレーエフ
Faleyev	ファレエフ
Fandorin	ファンドーリン
Farkhutdinov	ファルフジノフ
Fateyev	ファチェーエフ
Fatkulin	ファトクーリン
Fedichev	フェジーチェフ
Fyodorov	フョードロフ
Fedoseyev	フェドセーエフ
Fedosov	フェドソフ
Fedotov	フェドトフ
Fedyanin	フェジャニン
Feygin	フェイギン
Fetisov	フェチソフ
Filaleyev	フィラレーエフ
Filatov	フィラトフ
Filenkov	フィレンコフ
Filimonov	フィリモーノフ
Filipenko	フィリペンコ
Filippov	フィリッポフ
Filshin	フィリシン
Flistenko	フリスチェンコ
Fokin	フォーキン
Fomenko	フォメンコ
Fomin	フォミーン
Fomichyov	フォミチョーフ
Fonotov	フォノトフ
Fortov	フォルトフ
Fradkov	フラトコフ
Frolov	フロロフ
Furmanov	フルマノフ
Khabarov	ハバロフ
Khayryuzov	ハイリューゾフ
Khakimov	ハキーモフ
Khalevinsky	ハレヴィンスキー
Khalilov	ハリロフ
Khandruyev	ハンドルエフ
Khapov	ハーポフ
Kharitonov	ハリトノフ
Kharlamov	ハルラモフ
Kharlov	ハルロフ
Khachaturov	ハチャトゥロフ
Khachaturyan	ハチャトゥリャン
Khvatkov	フヴァトコフ
Khetagurov	ヘタグロフ
Khlebnikov	フレブニコフ
Khodkin	ホトキン
Khodyrev	ホードィレフ
Khozhatelev	ホジャチェレフ
Khomenko	ホメンコ
Khomutov	ホムトフ
Khoroshilov	ホロシロフ
Khotinenko	ホチネンコ
Khotochkin	ホトチキン
Khokhlov	ホフロフ
Khramchenkov	フラムチェンコフ
Khrenkov	フレンコフ
Khritnenkov	フリトネンコフ
Khromushin	フロムシン
Khrushchyov	フルショフ、フルシチョフ
Khrychyov	フルィチョフ
Khubiyev	フビエフ
Khudyayev	フジャーエフ
Khumarov	フマロフ
Khutanov	フタノフ
Tsapin	ツァピン
Tsaregorodtsev	ツァレゴロートツェフ
Tsarenko	ツァレンコ
Tsarkov	ツァリコフ
Tsvetkov	ツヴェトコフ
Tsepitsin	ツェピツィン
Tsibulsky	ツィブリスキー
Tsyganenko	ツィガネンコ
Tsyplakov	ツィプラコフ
Tsyplyayev	ツィプリャエフ
Chaykovsky	チャイコフスキー
Chaptynov	チャプトィノフ
Chebunin	チェブーニン
Chekmezov	チェクメゾフ
Chekrygin	チェクルィギン
Chelnokov	チェルノコフ
Chelyshev	チェルィシェフ
Chenchikov	チェンチコフ
Chervinsky	チェルヴィンスキー
Cheremnykh	チェレムヌィフ
Cheryomukhin	チェリョムヒン
Cherepkov	チェレプコフ
Cherkesov	チェルケソフ
Chernenko	チェルネンコ
Chernichenko	チェルニチェンコ
Chernov	チェルノフ
Chernogorov	チェルノゴロフ
Chernoivanov	チェルノイヴァノフ
Chernomyrdin	チェルノムイルジン
Chernousov	チェルノウソフ
Chernykh	チェルヌィフ
Chernyshyov	チェルヌィショフ
Chernyshevsky	チェルヌィシェフスキー
Chernyansky	チェルニャンスキー
Cherchesov	チェルチェソフ
Chesnokov	チェスノーコフ
Chetin	チェチン
Chekhov	チェーホフ
Chekhoyev	チェホエフ
Chechevatov	チェチェヴァトフ
Cheshenko	チェシェンコ
Chibisov	チビソフ
Chikin	チーキン
Chilingarov	チリンガロフ
Chirikov	チリコフ
Chirtsov	チルツォフ
Chistyakov	チスチャコフ
Chichelov	チチェロフ
Chlenov	チレノフ
Chuguyev	チュグーエフ
Chudinov	チュジノフ
Chukanov	チュカノフ
Chukovsky	チューコフスキー、チュコフスキー
Chunkov	チュニコフ
Chupin	チューピン
Churanov	チュラノフ
Churilov	チュリロフ
Churkin	チュルキン
Churkov	チュルコフ
Chukhin	チューヒン
Chyulkov	チュリコフ
Shabalin	シャバリン
Shabanov	シャバノフ
Shabdurasulov	シャブドゥラスロフ
Shabunin	シャブニン
Shadrikov	シャドリコフ
Shalavin	シャラーヴィン
Shalamov	シャラーモフ
Shamin	シャミン
Shamov	シャモフ
Shamrayev	シャムラエフ
Shamshin	シャムシン
Shamshurov	シャムシュロフ
Shandybin	シャンドィビン、シャンドイビン
Shankin	シャンキン
Shapkin	シャプキン
Shapovalenko	シャポヴァレンコ
Shapovalov	シャポヴァロフ
Shaposhnikov	シャポシュニコフ
Sharapov	シャラポフ
Sharov	シャローフ
Sharonov	シャロノフ
Sharutenko	シャルチェンコ
Sharygin	シャルィギン
Shatalin	シャターリン
Shatalov	シャタロフ
Shafranov	シャフラノフ
Shakhov	シャホフ
Shashkov	シャシュコーフ
Shashurin	シャシューリン
Shvedchenko	シュヴェトチェンコ
Shvetsov	シュヴェツォフ
Shevelyov	シェヴェリョフ
Shevchenko	シェフチェンコ
Sheremetev	シェレメチェフ
Shershunov	シェルシュノフ
Shestakov	シェスタコフ
Shestov	シェストフ
Shibayev	シバエフ
Shilov	シーロフ
Shipov	シーポフ
Shirobokov	シロボコフ
Shirshov	シルショフ
Shiryayev	シリャーエフ
Shikhalev	シハレフ
Shichanin	シチャーニン
Shishkin	シシュキン、シーシキン
Shishkov	シシュコフ
Shishlov	シシュロフ
Shklovsky	シュクロフスキー、シュクローフスキー
Shklyarov	シュクリャーロフ
Shkrabov	シュクラボフ
Shlyapin	シュリャピン
Shlyakhtin	シュリャフチン
Shmakov	シュマーコフ
Shmatov	シュマートフ
Sholokhov	ショーロホフ
Shorin	ショーリン
Shostakovsky	ショスタコフスキー
Shokhin	ショーヒン
Shtogrin	シュトグリン
Shubin	シュビン
Shuvalov	シュヴァロフ
Shuykov	シュイコフ
Shulepov	シュレポフ
Shulgin	シュリギーン
Shurchanov	シュルチャノフ
Shurchkov	シュルチコフ
Shuteyev	シュチェエフ
Shchapov	シャーポフ、シチャーポフ
Shchedrin	シェドリン、シチェドリン
Shchekochikhin	シェコチヒン、シチェコチヒン
Shcherbakov	シェルバコフ、シチェルバコフ
Shchukin	シューキン、シチューキン
Yugin	ユーギン
Yudin	ユージン
Yuzhanov	ユジャノフ
Yukov	ユーコフ
Yumashev	ユマーシェフ
Yurkov	ユルコフ
Yurev	ユリエフ
Yusupov	ユスーポフ
Yusufov	ユスーフォフ
Yushenkov	ユシェンコフ
Yushchenko	ユーシェンコ、ユーシチェンコ
Yablokov	ヤブロコフ
Yavlinsky	ヤヴリンスキー
Yagudin	ヤグージン（ヤグディン）
Yakimov	ヤキモフ
Yakovenko	ヤコヴェンコ
Yakovlev	ヤコヴレフ
Yakunin	ヤクーニン
Yakushev	ヤークシェフ
Yakushkin	ヤクーシュキン
Yamkin	ヤムキン
Yanvaryov	ヤンヴァリョフ
Yankovsky	ヤンコフスキー
Yanovsky	ヤノフスキー
Yarov	ヤーロフ
Yaroshenko	ヤロシェンコ
Yaskunov	ヤスクノフ
Yastrzhemsky	ヤストルジェムスキー
Yashin	ヤーシン