Abate	アバーテ
Abatino	アバティーノ
Abbatini	アッバティーニ
Abbiati	アッビアーティ
Abbondanza	アッボンダンツァ
Abelli	アベッリ
Abondio	アボンディオ
Abruzzi	アブルッツィ
Accardo	アッカルド
Acconci	アッコンチ
Acerbi	アチェールビ
Achilli	アキッリ
Adani	アダーニ
Addesi	アッデージ
Ademollo	アデモッロ
Adinolfi	アディノルフィ
Adornato	アドルナート
Affaitati	アッファイターティ
Agazzari	アガッツァーリ
Agazzi	アガッツィ
Aglietta	アッリェッタ
Agnelli	アニェッリ
Agnesi	アニェージ
Agogliati	アゴリヤーティ
Agosti	アゴスティ
Agostinelli	アゴスティネッリ
Agostini	アゴスティーニ
Agosto	アゴスト
Agricola	アグリーコラ
Aimaro	アイマーロ
Airola	アイローラ
Alabiso	アラビーゾ
Albanese	アルバネーゼ
Albani	アルバーニ
Albergetti	アルベルジェッティ
Alberini	アルベリーニ
Alberoni	アルベローニ
Alberti	アルベルティ
Albertini	アルベルティーニ
Albertosi	アルベルトージ
Albinoni	アルビノーニ
Alboni	アルボーニ
Alboreto	アルボレート
Alborghetti	アルボルゲッティ
Alderighi	アルデリーギ
Aldini	アルディーニ
Aldrovandi	アルドロヴァンディ
Aleotti	アレオッティ
Alessandri	アレッサンドリ
Alessandrini	アレッサンドリーニ
Alessandrino	アレッサンドリーノ
Alessi	アレッシ
Alfano	アルファーノ
Alibrandi	アリブランディ
Alighieri	アリギエリ、アリギエーリ
Aliprandi	アリプランディ
Aliprandini	アリプランディーニ
Allegri	アッレーグリ
Allegrini	アッレグリーニ
Aloisi	アロイージ
Altamura	アルタムーラ
Altobelli	アルトベッリ
Amadei	アマデイ
Amadeo	アマデーオ
Amati	アマーティ
Amato	アマート
Ambrosini	アンブロジーニ
Ambrosio	アンブロージオ
Ambrosoli	アンブロゾーリ
Amelia	アメーリア
Amenta	アメーンタ
Ametis	アメーティス
Amici	アミーチ
Ammaniti	アンマニーティ
Ammendola	アンメンドラ
Amodio	アモーディオ
Amore	アモーレ
Amoroso	アモローソ
Anastasi	アナスタージ
Ancelotti	アンチェロッティ
Andolfi	アンドールフィ
Andreatti	アンドレアッティ
Andreini	アンドレイニ
Andreoli	アンドレオーリ
Andreolli	アンドレオッリ
Andreoni	アンドレオーニ
Andreotti	アンドレオッティ
Anelli	アネッリ
Anerio	アネーリオ
Anesi	アネージ、アネーシ
Anfossi	アンフォッシ
Angelini	アンジェリーニ
Angelo	アンジェロ
Angelucci	アンジェルッチ
Anghileri	アンギレーリ
Angiolini	アンジョリーニ
Angioni	アンジョーニ
Annaloro	アンナローロ
Annovazzi	アンノヴァッツィ
Annunziata	アンヌンツィアータ
Ansaldi	アンサルディ
Anselmi	アンセルミ
Antinori	アンティノーリ
Antiseri	アンティゼリ
Antognoni	アントニョーニ
Antonella	アントネッラ
Antonelli	アントネッリ
Antonellini	アントネッリーニ
Antonello	アントネッロ
Antoni	アントーニ
Antonicelli	アントニチェッリ
Antonini	アントニーニ
Antonioni	アントニオーニ
Antonucci	アントヌッチ
Antonutti	アントヌッティ
Apicella	アピチェッラ
Appiano	アッピアーノ
Aprea	アプレーア
Aquilani	アクィラーニ
Aquilano	アクィラーノ
Arangi	アランジ
Arcaini	アルカイーニ
Ardelli	アルデッリ
Arenghi	アレンギ
Aretino	アレティーノ
Argento	アルジェント
Arienzo	アリエンツォ
Ariosti	アリオスティ
Ariosto	アリオスト
Armani	アルマーニ
Armanini	アルマニーニ
Armaroli	アルマローリ
Arrigoni	アッリゴーニ、アルリゴーニ
Arriva	アルリーヴァ、アリーヴァ
Artusi	アルトゥージ
Ascari	アスカーリ
Ascoli	アスコリ
Assandri	アッサンドリ
Astori	アストーリ
Augello	アウジェッロ
Auteri	アウテーリ
Autieri	アウティエリ
Autori	アウトーリ
Avati	アヴァティ
Averulino	アヴェルリーノ
Avogadro	アヴォガードロ
Avoledo	アヴォレード
Azzaretti	アッツァレッティ
Azzariti	アッツァリーティ
Baccara	バッカラ
Bacci	バッチ
Bacciocchi	バッチョッキ
Bachini	バキーニ
Baciocchi	バチョッキ
Bada	バーダ
Badini	バディーニ
Badioli	バディオリ
Badoglio	バドッリョ
Baggio	バッジョ
Baglioni	バッリョーニ
Bagnato	バニャート
Bagni	バーニ
Bagnoli	バニョーリ
Bajardi	バヤルディ
Balbo	バルボ
Baldassare	バルダッサーレ
Baldasseroni	バルダッセローニ
Baldessarini	バルデッサリーニ
Baldi	バルディ
Baldini	バルディーニ
Balducci	バルドゥッチ
Balestra	バレストラ、バレーストラ
Balivo	バリーヴォ
Ballantini	バッランティーニ
Ballista	バッリスタ
Ballottari	バッロッターリ
Balocco	バロッコ
Balotelli	バロテッリ
Balsamo	バルサモ
Banchieri	バンキエーリ
Bandera	バンデーラ
Bandinelli	バンディネッリ
Bandini	バンディニ
Banfi	バンフィ
Baracchi	バラッキ
Baraldi	バラルディ
Baratti	バラッティ
Barbari	バルバーリ
Barbato	バルバート
Barberi	バルベーリ
Barberini	バルベリーニ
Barbi	バルビ
Barbieri	バルビエリ
Barbirolli	バルビロッリ
Bardelli	バルデッリ
Bardi	バルディ
Bardini	バルディーニ
Baresi	バレージ
Baretta	バレッタ
Barigozzi	バリゴッツィ
Barini	バリーニ
Barioni	バリオーニ
Barlotti	バルロッティ
Barlozzi	バルロッツィ
Barocci	バロッチ
Barocco	バロッコ
Barone	バローネ
Baroni	バローニ
Baronio	バローニオ
Barracciu	バルラッチュ
Bartoletti	バルトレッティ
Bartoli	バルトリ
Bartolini	バルトリーニ
Bartolomasi	バルトロマージ
Bartolomei	バルトロメーイ
Bartolone	バルトローネ
Bartolozzi	バルトロッツィ
Bartolucci	バルトルッチ
Barzaghi	バルツァーギ
Barzagli	バルザッリ
Basiola	バジオーラ
Bassani	バッサーニ
Bassano	バッサーノ
Bassi	バッシ
Basso	バッソ
Bastianini	バスティアニーニ
Batoni	バトーニ
Battaglia	バッタッーリャ
Battilani	バッティラーニ
Battista	バッティスタ
Battistella	バッティステッラ
Battisti	バッティスティ
Battistini	バッティスティーニ
Battolla	バットッラ
Baudo	バウド
Bazzini	バッツィーニ
Bazzoni	バッツォーニ
Bearzatti	ベアルザッティ
Bearzot	ベアルツォット
Beccalossi	ベッカロッシ
Beccaria	ベッカリーア
Bechis	ベキス
Bedulli	ベドゥッリ
Bella	ベッラ
Bellanova	ベッラノーヴァ
Bellavia	ベッラヴィーア
Bellenghi	ベレンギ
Bellezza	ベッレッツァ
Belli	ベッリ
Bellincampi	ベッリンカンピ
Bellincioni	ベリンチョーニ
Bellini	ベッリーニ
Bello	ベッロ
Bellocchio	ベッロッキオ
Belloni	ベッローニ
Bellotti	ベッロッティ
Bellotto	ベッロット
Bellucci	ベッルッチ、ベルッチ
Bellugi	ベッルージ
Belmondo	ベルモンド
Belotti	ベロッティ
Beltrami	ベルトラーミ
Benaglio	ベナッリョ
Benassi	ベナッシ
Bendandi	ベンダンディ
Bendicenti	ベンディチェンティ
Benedetti	ベネデッティ
Benelli	ベネッリ
Benetti	ベネッティ
Benevoli	ベネヴォリ、ベネーヴォリ
Benigno	ベニーニョ
Benini	ベニーニ
Benvenuti	ベンヴェヌーティ
Berardi	ベラルディ
Berardino	ベラルディーノ
Berdini	ベルディーニ
Bergamini	ベルガミーニ
Bergamino	ベルガミーノ
Bergamo	ベルガモ
Bergoglio	ベルゴーリョ
Bergomi	ベールゴミ
Bergonzi	ベルゴンツィ
Berini	ベリーニ
Berio	ベーリオ
Berlinghieri	ベルリンギエーリ
Berlusconi	ベルルスコーニ
Berluti	ベルルーティ
Bernardi	ベルナルディ
Bernardini	ベルナルディーニ
Bernasconi	ベルナスコーニ
Berneri	ベルネーリ
Berni	ベルニ
Berruti	ベッルーティ
Bersani	ベルサーニ
Bertagna	ベルターニャ
Bertali	ベルターリ
Bertani	ベルターニ
Bertazzo	ベルタッツォ
Bertè	ベルテ
Berti	ベルティ
Bertinelli	ベルティネッリ
Bertini	ベルティーニ
Bertinotti	ベルティノッティ
Bertocchi	ベルトッキ
Bertoia	ベルトイア
Bertolini	ベルトリーニ
Bertolino	ベルトリーノ
Bertolotto	ベルトロット
Bertoncini	ベルトンチーニ
Bertone	ベルトーネ
Bertoni	ベルトーニ
Bertotto	ベルトット
Bertucchi	ベルトゥッキ
Bertucci	ベルトゥッチ
Besanzoni	ベザンツォーニ
Bettarini	ベッタリーニ
Bettega	ベッテガ
Betti	ベッティ
Bettinelli	ベッティネッリ
Bettini	ベッティーニ
Bettoni	ベットーニ
Bevacqua	ベヴァックヮ
Bevilacqua	ベヴィラックワ
Bezzini	ベッツィーニ
Biagetti	ビアジェッティ
Biagiotti	ビアジョッティ
Bianchetti	ビアンケッティ
Bianchi	ビアンキ
Bianchini	ビアンキーニ
Bianco	ビアンコ
Biasini	ビアジーニ（ビアシーニ）
Biazzi	ビアッツィ
Bigatto	ビガット
Bigliardi	ビッリャルディ
Bigliazzi	ビッリャッツィ
Bigon	ビゴン
Bigoni	ビゴーニ
Biliotti	ビリオッティ
Binci	ビンチ
Bini	ビーニ
Biondelli	ビオンデッリ
Biorcati	ビオルカーティ
Birindelli	ビリンデッリ
Bisatti	ビザッティ
Biscardini	ビスカルディーニ
Bissa	ビッサ
Bissolati	ビッソラーティ
Bisutti	ビズッティ
Bitonto	ビトーント
Blasi	ブラージ
Blini	ブリーニ
Blotto	ブロット
Bobbio	ボッビオ
Bocca	ボッカ
Boccacini	ボッカチーニ
Boccassini	ボッカッシーニ、ボカッシーニ
Boccherini	ボッケリーニ
Bocchi	ボッキ
Bocchiddi	ボッキッディ
Bocci	ボッチ
Bocciardo	ボッチャールド
Boccioni	ボッチョーニ
Boccoli	ボッコリ
Boccolini	ボッコリーニ
Bocconi	ボッコーニ
Bocelli	ボチェッリ
Boiardo	ボイアールド
Boito	ボーイト
Boldrini	ボルドリーニ
Bolognini	ボロニーニ
Bombelli	ボンベッリ
Bombieri	ボンビエリ
Bompiani	ボンピアーニ
Bona	ボナ
Bonaccorti	ボナッコルティ
Bonaga	ボナーガ
Bonanno	ボナンノ
Bonato	ボナート
Bonatta	ボナッタ
Bonaventura	ボナヴェントゥーラ
Bonazzoli	ボナッツォーリ
Bonci	ボンチ
Boncompagni	ボンコンパーニ
Bondi	ボンディ
Bondino	ボンディーノ
Bonelli	ボネッリ
Bonera	ボネーラ
Bonetti	ボネッティ
Bonetto	ボネット
Bonfanti	ボンファンティ
Bonferroni	ボンフェローニ
Boni	ボーニ
Bonifaccio	ボニファッチョ
Bonifacio	ボニファーチョ
Bonini	ボニーニ
Bonino	ボニーノ
Boninsegna	ボニンセーニャ
Bonisolli	ボニゾッリ
Bono	ボーノ
Bonomi	ボノーミ
Bononi	ボノーニ
Bonporti	ボンポルティ
Bontempi	ボンテンピ
Bonucci	ボヌッチ
Borchi	ボルキ
Borciani	ボルチャーニ
Bordiga	ボルディーガ
Borgatti	ボルガッティ
Borghese	ボルゲーゼ
Borghesio	ボルゲージオ
Borghi	ボルギ
Borgianni	ボルジャンニ
Borgioli	ボルジョリ
Borgonovo	ボルゴノーヴォ
Borrelli	ボッレッリ、ボルレッリ
Borroni	ボルローニ
Bortolotti	ボルトロッティ
Borzi	ボルツィ
Boschetti	ボスケッティ
Boschi	ボスキ
Bosio	ボージオ
Bossi	ボッシ
Botta	ボッタ
Bottacchiari	ボッタッキアーリ、ボッタッキャーリ
Bottazzo	ボッタッツォ
Bottesini	ボッテジーニ（ボッテシーニ）
Botti	ボッティ
Bovi	ボーヴィ
Bovolenta	ボヴォレンタ
Bozza	ボッツァ
Bozzetto	ボッツェット
Bozzi	ボッツィ
Bracco	ブラッコ
Braga	ブラーガ
Bragaglia	ブラガーリャ
Bragazzi	ブラガッツィ
Bramani	ブラマーニ
Brambilla	ブランビッラ
Branca	ブランカ
Branchini	ブランキーニ
Brandi	ブランディ
Brando	ブランド
Branzoli	ブランツォーリ
Braschi	ブラスキ
Brengola	ブレンゴーラ
Brero	ブレロ
Bressa	ブレッサ
Bressan	ブレッサン
Brevi	ブレーヴィ
Breviario	ブレヴィアーリオ
Briatore	ブリアトーレ
Brignoli	ブリニョーリ
Brio	ブリオ
Brivio	ブリーヴィオ
Brizzi	ブリッツィ
Brocca	ブロッカ
Brocchi	ブロッキ
Broggini	ブロッジーニ
Brondi	ブロンディ
Bronzini	ブロンツィーニ
Broschi	ブロスキ
Brosio	ブロージオ
Brugnatelli	ブルニャテッリ
Brugnoli	ブルニョーリ
Bruna	ブルーナ
Brunelli	ブルネッリ
Brunetti	ブルネッティ
Bruni	ブルーニ
Bruno	ブルーノ
Brusasco	ブルザスコ
Bruschi	ブルスキ
Bruscolotti	ブルスコロッティ
Brutti	ブルッティ
Brutto	ブルット
Bubbico	ブッビコ
Buccella	ブッチェッラ
Buccellati	ブッチェッラーティ
Buccellato	ブッチェッラート、ブッチェラート
Bucchi	ブッキ
Bucci	ブッチ
Bucciarelli	ブッチャレッリ
Buccilli	ブッチッーリ
Bugatti	ブガッティ
Buitoni	ブイトーニ
Buonomo	ブオノーモ
Buozzi	ブオッツィ
Buratti	ブラッティ
Burchiellaro	ブルキエッラーロ
Burco	ブルコ
Buriani	ブリアーニ
Burzio	ブルツィオ
Busoni	ブゾーニ
Bussotti	ブッソッティ（ブソッティ）
Buticchi	ブティッキ
Cabrini	カブリーニ
Cacace	カカーチェ
Caccini	カッチーニ
Cacioppo	カチョッポ
Cafaro	カファロ
Caggiano	カッジャーノ
Cagliari	カッリャリ
Cagliero	カッリェーロ
Cagnoni	カニョーニ
Caianiello	カイアニエッロ
Calabi	カラビ
Calabrese	カラブレーゼ
Calace	カラーチェ
Calamai	カラマーイ
Calandra	カランドラ
Calandrelli	カランドレッリ
Calcaterra	カルカテルラ
Caldara	カルダーラ
Calderara	カルデラーラ
Calderone	カルデローネ
Calderoni	カルデローニ
Calenda	カレンダ
Caliri	カリーリ
Calissano	カリッサーノ
Callà	カッラ
Calloni	カッローニ
Calogero	カロージェロ
Calori	カローリ
Caltabiano	カルタビアーノ
Calvi	カルヴィ
Calvino	カルヴィーノ
Calza	カルツァ
Calzolari	カルツォラーリ
Cambianica	カンビアニカ
Cambiaso	カンビアーゾ
Cambini	カンビーニ
Camerino	カメリーノ
Camerlengo	カメルレンゴ
Camicia	カミーチャ
Camillo	カミッロ
Camocardi	カモカルディ
Camoranesi	カモラネージ
Campagnano	カンパニャーノ
Campagnola	カンパニョーラ
Campanari	カンパナーリ
Campanella	カンパネッラ
Campani	カンパーニ
Campisi	カンピージ
Campora	カンポーラ
Campra	カンプラ
Canali	カナーリ
Cancellieri	カンチェッリエーリ
Candeloro	カンデローロ
Candiani	カンディアーニ
Canetti	カネッティ
Caniglia	カニッリャ
Canini	カニーニ
Cannavacciuolo	カンナヴァッチュオロ
Cannavaro	カンナヴァーロ
Cannizzaro	カンニッツァーロ
Canova	カノーヴァ
Cantarella	カンタレッラ
Cantarelli	カンタレッリ
Cantelli	カンテッリ
Cantoni	カントーニ
Caovilla	カオヴィッラ
Capasa	カパーザ
Capecchi	カペッキ
Capece	カペーチェ
Capelletti	カペッレッティ
Capelli	カペッリ
Capellini	カペッリーニ
Capello	カペッロ
Capitanio	カピターニオ
Capizzi	カピッツィ
Caponi	カポーニ
Capovilla	カポヴィッラ
Cappa	カッパ
Cappelletti	カッペッレッティ
Cappelli	カッペッリ
Cappellini	カッペッリーニ
Cappello	カッペッロ
Capponi	カッポーニ
Cappuccilli	カプッチッリ
Capua	カプア
Capuana	カプアーナ
Capucci	カプッチ
Capulli	カプッリ
Caputo	カプート
Caracciolo	カラッチョロ
Caratelli	カラテッリ
Carbone	カルボーネ
Carbonera	カルボネラ
Carboni	カルボーニ
Carcassi	カルカッシ
Cardano	カルダーノ
Cardia	カルディア
Cardinale	カルディナーレ
Carducci	カルドゥッチ
Carella	カレッラ
Carelli	カレッリ
Carfagna	カルファーニャ
Cargini	カルジーニ
Caria	カリア
Caridi	カリディ
Carignani	カリニャーニ
Carillo	カリッロ
Carini	カリーニ
Carissimi	カリッシミ
Carlei	カルレーイ
Carletti	カルレッティ
Carli	カルリ
Carlini	カルリーニ
Carlone	カルローネ
Carlucci	カルルッチ
Carmignola	カルミニョーラ
Carminati	カルミナーティ
Carnevale	カルネヴァーレ
Carnimeo	カルニメーオ
Carosio	カロージオ
Carrà	カッラ
Carrisi	カルリージ
Carta	カルタ
Carteri	カルテーリ
Carulli	カルッリ
Caruso	カルーゾ（カルーソー）
Casale	カザーレ
Casapietra	カサピエトラ
Casarini	カザリーニ
Casavola	カザーヴォラ（カサヴォーラ）
Casciari	カシャーリ
Cascone	カスコーネ
Casella	カゼッラ
Casellato	カゼラート
Caselli	カゼッリ
Casini	カジーニ、カシーニ
Casiraghi	カシラーギ、カジラーギ
Casoni	カゾーニ
Cassamagnaghi	カッサマニャーギ
Cassani	カッサーニ
Cassano	カッサーノ
Cassinelli	カッシネッリ
Cassola	カッソーラ
Castagnone	カスタニョーネ
Castellana	カステッラーナ
Castellani	カステッラーニ
Castellazzi	カステッラッツィ
Castelli	カステッリ
Castellini	カステッリーニ
Castellitto	カステッリーット
Castellucci	カステッルッチ
Castelnuovo	カステルヌオーヴォ
Castigliano	カスティリャーノ
Castiglione	カスティッリョーネ、カスティリオーネ
Castiglioni	カスティッリョーニ、カスティリオーニ
Castrogiovanni	カストロジョヴァンニ
Catalani	カタラーニ
Catalano	カタラーノ
Catella	カテッラ
Catone	カトーネ
Cattaneo	カッターネオ
Cattini	カッティーニ
Catullo	カトゥッロ
Causio	カウジオ
Cavagnis	カヴァニス
Cavalcanti	カヴァルカンティ
Cavalera	カヴァレーラ
Cavalieri	カヴァリエリ
Cavallari	カヴァッラーリ
Cavallaro	カヴァッラーロ
Cavalli	カヴァッリ
Cavallini	カヴァッリーニ、カヴァリーニ
Cavallo	カヴァッロ、カヴァルロ
Cavallone	カヴァッローネ
Cavallotti	カヴァロッティ
Cavazza	カヴァッツァ
Cavazzoni	カヴァッツォーニ
Cazzati	カッツァーティ
Ceccarelli	チェッカレッリ
Ceccarossi	チェッカロッシ
Cecchele	チェッケーレ
Cecchi	チェッキ
Cecchini	チェッキーニ
Cecconi	チェッコーニ
Celeghin	チェレギン
Celentano	チェレンターノ
Celino	チェリーノ
Celletti	チェッレッティ
Cellini	チェッリーニ
Cenami	チェナーミ
Censi	チェンシ
Centurelli	チェントゥレッリ
Centurione	チェントゥリオーネ
Ceravolo	チェラーヴォロ
Cernuschi	チェルヌスキ
Cerquetti	チェルクウェッティ、チェルクェッティ
Cerquozzi	チェルクウォッツィ
Cerra	チェルラ
Cerreti	チェルレーティ
Cerri	チェッリ
Cerruti	チェッルーティ
Cerutti	チェルッティ
Cervo	チェルヴォ
Cesari	チェーザリ
Ceste	チェステ
Cesti	チェスティ
Ceva	チェーヴァ
Chiappini	キアッピーニ
Chiara	キアーラ
Chiaromonte	キアロモンテ、キャロモンテ
Chiarugi	キアルージ、キャルージ
Chiavassa	キャヴァッサ、キアヴァッサ
Chiellini	キエッリーニ
Chiesa	キエザ
Chimenti	キメンティ
Chinaglia	キナッリャ
Chirico	キリコ
Ciaffi	チャッフィ
Cialdini	チャルディーニ
Ciampi	チャンピ
Ciani	チャーニ（チアーニ）
Ciapponi	チャッポーニ
Ciaramella	チャラメッラ
Ciccarelli	チッカレッリ
Cicci	チッチ
Ciccia	チッチャ
Cicco	チッコ
Ciccolini	チッコリーニ
Ciccone	チッコーネ
Cicerone	チチェローネ
Cicogna	チコーニャ
Cifarelli	チファレッリ
Cifra	チーフラ
Cigada	チガーダ
Cigoli	チーゴリ
Cilea	チレア、チレーア
Cima	チーマ
Cimara	チマーラ
Cimarosa	チマローザ
Cimenti	チメンティ
Cinelli	チネッリ
Cini	チーニ
Ciniselli	チニゼッリ
Cinquegrana	チンクェグラーナ
Cinquetti	チンクウェッティ
Cinzano	チンツァーノ
Ciocci	チョッチ
Ciociano	チョチャーノ
Cioni	チョーニ
Cipollini	チポッリーニ
Cipriani	チプリアーニ
Cipriano	チプリアーノ
Cirillo	チリッロ
Cirino	チリーノ
Cisi	チージ
Citaristi	チタリスティ
Citterio	チッテーリオ
Citti	チッティ
Civirani	チヴィラーニ
Civoli	チヴォリ
Clementi	クレメンティ
Clerici	クレリチ
Cobelli	コベッリ
Cocchi	コッキ
Cocci	コッチ
Coccia	コッチャ
Cocco	コッコ
Colafranceschi	コラフランチェスキ
Colaiuta	コラユータ
Colavolpe	コラヴォルペ
Colella	コレッラ
Coletti	コレッティ
Colleoni	コッレオーニ
Colli	コッリ
Collodi	コッローディ
Colloredo	コッロレード
Collovati	コッロヴァーティ
Colnaghi	コルナーギ
Colombi	コロンビ
Colombini	コロンビーニ
Colombo	コロンボ
Colonna	コロンナ
Colonnetti	コロンネッティ
Colosio	コロージオ
Colucci	コルッチ
Columbro	コルンブロ
Colussi	コルッシ
Colzani	コルツァーニ
Comandini	コマンディーニ
Comelli	コメッリ
Concato	コンカート
Conciatori	コンチャトーリ
Concone	コンコーネ
Confalonieri	コンファロニエーリ
Confortola	コンフォルトーラ
Consoli	コンソリ
Consorti	コンソールティ
Contarini	コンタリーニ
Conte	コンテ
Contesti	コンテスティ
Conti	コンティ
Contin	コンティン
Contini	コンティーニ
Copertini	コペルティーニ
Coppa	コッパ
Coppola	コッポラ
Coppolino	コッポリーノ
Corazzini	コラッツィーニ
Corbucci	コルブッチ
Corelli	コレッリ
Corghi	コルギ
Corli	コルリ
Corradetti	コッラデッティ
Corradi	コッラーディ
Corradini	コルラディーニ、コッラディーニ
Correani	コルレアーニ
Correggio	コッレッジョ
Corri	コッリ
Corridori	コッリドーリ
Corsi	コルシ
Corsini	コルシーニ
Cortazzi	コルタッツィ
Cortese	コルテーゼ
Corti	コルティ
Cortinovis	コルティノーヴィス
Corvisieri	コルヴィジエリ
Coscioni	コショーニ
Cosentino	コゼンティーノ
Cossotto	コッソット
Cossutta	コッスッタ
Costa	コスタ
Costacurta	コスタクルタ
Costantini	コスタンティーニ
Costantino	コスタンティーノ
Costanzo	コスタンツォ
Costazza	コスタッツァ
Cotogni	コトーニ
Cottinelli	コッティネッリ
Coveri	コヴェリ
Cozzi	コッツィ
Crasso	クラッソ
Cravero	クラヴェロ
Crepaldi	クレパルディ
Crescenzi	クレッシェンツィ
Crestani	クレスターニ
Creti	クレーティ
Crimi	クリミ
Crippa	クリッパ
Cristiani	クリスティアーニ
Cristinelli	クリスティネッリ
Cristoforetti	クリストフォレッティ
Crocco	クロッコ
Croce	クローチェ
Cuccarini	クッカリーニ
Cucchi	クッキ
Cuccureddu	クックレッドゥ
Cucinotta	クチノッタ
Cupisti	クピスティ
Curci	クルチ
Curione	クリオーネ
Curzio	クールツィオ
D'Addario	ダッダーリオ
D'Agostino	ダゴスティーノ
D'Albora	ダルボラ
D'Alema	ダレーマ
D'Alessio	ダレッシオ
D'Alfonso	ダルフォンソ
D'Alia	ダリア
D'Amato	ダマート
D'Amico	ダミーコ
D'Angelo	ダンジェロ
D'Antoni	ダントーニ
D'Aquino	ダクウィーノ
D'Arienzo	ダリエンツォ
D'Avolio	ダヴォーリオ
D'Avorio	ダヴォーリオ
D'India	ディンディア
D'Onghia	ドンギア
D'Orazi	ドラーツィ
D'Orazio	ドラーツィオ
D'Orsi	ドルシ
Dainelli	ダイネッリ
Dalberto	ダルベルト
Daldossi	ダルドッシ
Dalessandro	ダレッサンドロ
Dalessio	ダレッシオ
Dall'Aglio	ダッラリーヨ
Dall'Argine	ダッラルジーネ
Dalla Chiesa	ダッラ・キエーザ
Dalla Rizza	ダッラ・リッツァ
Dallapiccola	ダッラピッコラ
Damerini	ダメリーニ
Damiani	ダミアーニ
Dandini	ダンディーニ
Dandolo	ダンドロ
Danieli	ダニエリ
Daolio	ダオーリオ
Dapporto	ダッポールト
Davia	ダヴィア
De Benedictis	デ・ベネディクティス
De Bono	デ・ボーノ
De Cecco	デ・チェッコ
De Chirico	デ・キリコ
De Corato	デ・コラート
De Fabiani	デ・ファビアーニ
De Feo	デ・フェオ
De Gasperi	デ・ガスペリ
De Giovanni	デ・ジョヴァンニ
De Laurentiis	デ・ラウレンティース
De Laurentis	デ・ラウレンティス
De Lorenzi	デ・ロレンツィ
De Luca	デ・ルカ
De Lucchi	デ・ルッキ
De Macchi	デ・マッキ
De Micheli	デ・ミケーリ
De Nanni	デ・ナンニ
De Palma	デ・パルマ
De Paoli	デ・パオリ
De Piscopo	デ・ピスコポ
De Ponti	デ・ポンティ
De Riso	デ・リーゾ
De Roberto	デ・ロベルト
De Rossi	デ・ロッシ
De Sabata	デ・サバタ
De Sanctis	デ・サンクティス
De Santis	デ・サンティス
De Seta	デ・セータ
De Sica	デ・シーカ
De Vita	デ・ヴィータ
Deangelis	デアンジェリス
Degani	デガーニ
Del Corvo	デル・コルヴォ
Del Donno	デル・ドンノ
Del Mastro	デル・マストロ
Del Monaco	デル・モナコ
Del Pezzo	デル・ペッツォ
Del Testa	デル・テスタ
Del Vecchio	デル・ヴェッキオ
Deledda	デレッダ
Dell'Acqua	デラックワ
Dell'Orefice	デッロレフィチェ
Della Casa	デッラ・カーザ
Dellasega	デッラセーガ
Delle Piane	デッレ・ピアーネ
Delminio	デルミーニオ
Delneri	デルネーリ
Delrio	デルリオ、デルリーオ
Deluca	デルカ
Delvecchio	デルヴェッキオ
Demarchi	デマルキ
Demarco	デマルコ
Demartini	デマルティーニ
Demartino	デマルティーノ
Demuro	デムーロ
Dentella	デンテッラ
Denza	デンツァ
Deodato	デオダート
Derossi	デロッシ
Desantis	デサンティス
Desderi	デズデーリ
Dessi	デッシ
Di Bello	ディ・ベッロ
Di Biagio	ディ・ビアージョ
Di Buono	ディ・ブオノ
Di Canio	ディ・カーニオ
Di Centa	ディ・チェンタ
Di Cicco	ディ・チッコ
Di Cioccio	ディ・チョッチョ
Di Francescantonio	ディ・フランチェスカントニオ
Di Giacomo	ディ・ジャコモ
Di Gioia	ディ・ジョイア
Di Giorgio	ディ・ジョルジョ
Di Monte	ディ・モンテ
Di Nanni	ディ・ナンニ
Di Palma	ディ・パルマ
Di Pinto	ディ・ピント
Di Riso	ディ・リーゾ
Di Roberto	ディ・ロベルト
Di Stefano	ディ・ステーファノ
Di Vaio	ディ・ヴァイオ
Diaco	ディアーコ
Dibella	ディベッラ
Dibenedetto	ディベネデット
Digiacomo	ディジャコモ
Dimatteo	ディマッテオ
Dini	ディーニ
Dionisi	ディオニージ
Dionisotti	ディオニゾッティ
Disraeli	ディズラエリ
Dolce	ドルチェ
Domeniconi	ドメニコーニ
Dominici	ドミニチ
Donadoni	ドナドーニ
Donati	ドナーティ
Donato	ドナート
Donatoni	ドナトーニ
Donizetti	ドニゼッティ
Dossena	ドッセーナ
Dossi	ドッシ
Dotti	ドッティ
Dovizioso	ドヴィツィオーゾ
Draghi	ドラーギ
Dragonetti	ドラゴネッティ
Drei	ドレイ
Droetto	ドロエット
Drovandi	ドロヴァンディ
Ducci	ドゥッチ
Dulbecco	ドゥルベッコ
Duni	ドゥーニ
Durante	ドゥランテ
Eco	エーコ
Einaudi	エイナウディ
Emili	エミリ
Epifani	エピファーニ
Epifanio	エピファーニオ
Ercolani	エルコラーニ
Ermanno	エルマンノ
Ermini	エルミーニ
Errico	エリーコ
Esposito	エスポージト
Esposti	エスポスティ
Eustachio	エウスターキオ
Evangelista	エヴァンジェリスタ
Evangelisti	エヴァンジェリスティ
Ezechiele	エゼキエーレ
Fabbri	ファッブリ
Fabiani	ファビアーニ
Facchetti	ファッケッティ
Facchinetti	ファッキネッティ
Facchini	ファッキーニ
Faccio	ファッチョ
Fadini	ファディーニ
Faggin	ファッジン
Fagioli	ファジョーリ
Fago	ファーゴ
Faiella	ファイエッラ
Failoni	ファイローニ
Falaguasta	ファラグヮスタ
Falcone	ファルコーネ
Fallaci	ファラーチ
Falzone	ファルツォーネ
Fanchini	ファンキーニ
Fanelli	ファネッリ
Fanfani	ファンファーニ
Fano	ファーノ
Fantini	ファンティーニ
Fantoni	ファントーニ
Farelli	ファレッリ
Farina	ファリーナ
Farinelli	ファリネッリ
Farini	ファリーニ
Farioli	ファリオーリ
Farisoglio	ファリゾッリョ
Farnese	ファルネーゼ
Farneti	ファルネティ
Fassi	ファッシ
Fassina	ファッシーナ
Fassini	ファッシーニ
Fattori	ファットーリ
Fattorini	ファットリーニ
Favalli	ファヴァッリ
Favaretto	ファヴァレット
Favero	ファヴェーロ
Fazzi	ファッツィ
Fazzuoli	ファッツォーリ
Fedele	フェデーレ
Fedeli	フェデーリ
Federici	フェデリーチ
Fellini	フェッリーニ
Feltrinelli	フェルトリネッリ
Fenaroli	フェナローリ
Fenini	フェニーニ
Ferilli	フェリッリ
Fermi	フェルミ
Fernandi	フェルナンディ
Feroldi	フェロルディ
Ferracci	フェルラッチ
Ferragamo	フェラガモ、フェッラガーモ
Ferrani	フェッラーニ
Ferrara	フェッラーラ
Ferrari	フェッラーリ、フェラーリ
Ferrario	フェッラーリオ
Ferraris	フェッラーリス、フェラーリス
Ferraro	フェッラーロ
Ferreri	フェッレーリ
Ferrero	フェッレーロ
Ferretti	フェルレッティ
Ferri	フェッリ、フェルリ
Ferrieri	フェッリエーリ、フェリエーリ
Ferrini	フェッリーニ
Ferro	フェッロ
Ferrone	フェルローネ、フェッローネ
Festa	フェスタ
Fiacconi	フィアッコーニ
Fiamma	フィアンマ
Ficini	フィチーニ
Ficino	フィチーノ
Figliolini	フィリョリーニ
Filipepi	フィリペーピ
Filippeschi	フィリッペスキ
Filippetti	フィリッペッティ
Filippi	フィリッピ
Filippini	フィリッピーニ
Filogamo	フィロガモ
Finazzi	フィナッツィ
Fineschi	フィネスキ
Finetti	フィネッティ
Fini	フィーニ
Finocchiaro	フィノッキアーロ
Finzi	フィンツィ
Fioravanti	フィオラヴァンティ
Fiore	フィオーレ
Fiorello	フィオレッロ
Fiorentini	フィオレンティーニ
Fiorentino	フィオレンティーノ
Fiorenza	フィオレンツァ
Fiorenzi	フィオレンツィ
Fioretti	フィオレッティ
Fiori	フィオリ
Fiorillo	フィオリッロ
Fiorina	フィオリーナ
Fiorini	フィオリーニ
Fiorino	フィオリーノ
Fischietti	フィスキエッティ
Fizzarotti	フィッツァロッティ
Flachi	フラーキ
Flavi	フラーヴィ
Floccari	フロッカリ
Florio	フローリオ
Fogazzi	フォガッツィ
Folchitto	フォルキット
Fonda	フォンダ
Fontana	フォンターナ
Fontanesi	フォンタネージ
Forcellino	フォルチェッリーノ
Foresti	フォレスティ
Forino	フォリーノ
Forioso	フォリオーソ
Formichetti	フォルミケッティ
Formichi	フォルミーキ
Formichini	フォルミキーニ
Formiconi	フォルミコーニ
Formigli	フォルミッリ
Forte	フォルテ、フォールテ
Forti	フォルティ
Fortunata	フォルトゥナータ
Fortunato	フォルトゥナート
Forzano	フォルツァーノ
Fossati	フォサーティ
Fracassi	フラカッシ
Fracastoro	フラカストロ、フラカストーロ
Francardi	フランカルディ
Francesca	フランチェスカ
Francescantonio	フランチェスカントニオ
Francescatti	フランチェスカッティ
Franceschi	フランチェスキ
Franceschini	フランチェスキーニ
Franchetti	フランケッティ
Franchi	フランキ
Franchini	フランキーニ
Franci	フランチ
Franco	フランコ
Franzini	フランツィーニ
Franzoni	フランツォーニ
Frascani	フラスカーニ
Fraschini	フラスキーニ
Fratello	フラテッロ
Fratini	フラティーニ
Frazzi	フラッツィ
Frazzoni	フラッツォーニ
Freddi	フレッディ
Fregoli	フレゴリ
Freni	フレーニ
Frescobaldi	フレスコバルディ
Frezza	フレッツァ
Frigimelica	フリジメリカ
Frisoni	フリゾーニ
Frontini	フロンティーニ
Fronzetti	フロンツェッティ
Frucci	フルッチ
Frullani	フルッラーニ
Frusciante	フルシャンテ
Frustalupi	フルスタルーピ
Fucci	フッチ
Fuligni	フリーニ
Fumagalli	フマガッリ
Furlanetto	フルラネット
Fuselli	フゼッリ
Gabanelli	ガバネッリ
Gabriele	ガブリエーレ
Gabrieli	ガブリエリ
Gabrielli	ガブリエッリ
Gaburro	ガブールロ
Gadda	ガッダ
Gaddi	ガッディ
Gagliano	ガッリャーノ
Gagliardi	ガッリャールディ
Gaio	ガーイオ
Galassi	ガラッシ
Galbiati	ガルビアーティ
Galeazzo	ガレアッツォ
Galiani	ガリアーニ
Galie	ガリエ
Galilei	ガリレイ
Galletti	ガレッティ
Galli	ガッリ
Gallignani	ガッリニャーニ
Gallini	ガッリーニ
Gallo	ガッロ
Gallone	ガッローネ
Galloni	ガッローニ
Galuppi	ガルッピ
Galvani	ガルヴァーニ
Gambarotta	ガンバロッタ
Gamberini	ガンベリーニ
Gambino	ガンビーノ
Gandini	ガンディーニ
Gandolfi	ガンドルフィ
Gandolfo	ガンドルフォ
Garavani	ガラヴァーニ
Garavello	ガラヴェッロ
Garaventa	ガラヴェンタ
Garbin	ガルビン
Garbolino	ガルボリーノ
Gardella	ガルデッラ
Gardini	ガルディーニ
Garibaldi	ガリバルディ
Gariboldi	ガリボルディ
Garini	ガリーニ
Garitta	ガリッタ
Garrani	ガルラーニ
Gasco	ガスコ
Gasparini	ガスパリーニ
Gastoldi	ガストルディ
Gastoni	ガストーニ
Gattelli	ガッテッリ
Gatti	ガッティ
Gattini	ガッティーニ
Gattinoni	ガッティノーニ
Gatto	ガット
Gattuso	ガットゥーゾ
Gaudino	ガウディーノ
Gavazzi	ガヴァッツィ
Gazzaniga	ガッツァニーガ
Gedda	ジェッダ
Gemello	ジェメッロ
Geminiani	ジェミニアーニ
Gemma	ジェンマ
Generali	ジェネラーリ
Genta	ジェンタ
Gentile	ジェンティーレ
Gentileschi	ジェンティレスキ
Gentili	ジェンティーリ
Gentiloni	ジェンティローニ
Gerardi	ジェラルディ
Gerelli	ジェレッリ
Gerini	ジェリーニ
Germani	ジェルマーニ
Germanotta	ジェルマノッタ
Germi	ジェルミ
Gervasio	ジェルヴァジオ
Gesualdo	ジェズアルド
Ghedini	ゲディーニ
Gherardi	ゲラルディ
Gherardini	ゲラルディーニ
Gherlinzoni	ゲルリンツォーニ
Ghezzi	ゲッツィ
Ghiacci	ギアッチ
Ghiglia	ギッリャ
Ghiglioni	ギッリョーニ
Ghioni	ギオーニ
Ghirardani	ギラルダーニ
Ghirardini	ギラルディーニ
Ghirlanda	ギルランダ
Ghirotti	ギロッティ
Ghislandi	ギズランディ
Ghislanzoni	ギスランツォーニ
Ghitti	ギッティ
Ghizzi	ギッツィ
Giacconi	ジャッコーニ
Giachetta	ジャケッタ
Giacobbe	ジャコッベ
Giacobbi	ジャコッビ
Giacomelli	ジャコメッリ
Giacometti	ジャコメッティ
Giacomini	ジャコミーニ
Giacomotti	ジャコモッティ
Giacosa	ジャコーザ
Giaiotti	ジャイオッティ
Giampalmo	ジャンパルモ
Giampietri	ジャンピエトリ
Giandonato	ジャンドナート
Gianella	ジャネッラ
Giani	ジャーニ
Giannelli	ジャンネッリ
Gianni	ジャンニ
Giannini	ジャンニーニ
Giannoni	ジャンノーニ
Giaquinto	ジャクウィント
Giardini	ジャルディーニ
Gigi	ジージ
Gigli	ジーリ
Gigliotti	ジリョッティ
Gilardino	ジラルディーノ
Giletti	ジレッティ
Gilli	ジッリ
Ginastera	ジナステラ
Ginelli	ジネッリ
Gioffrè	ジョフレ
Gioia	ジョイア
Giordana	ジョルダーナ
Giordani	ジョルダーニ
Giordano	ジョルダーノ
Giorgetti	ジョルジェッティ
Giorgi	ジョルジ
Giorgini	ジョルジーニ
Giovagnoli	ジョヴァニョーリ
Giovanardi	ジョヴァナルディ
Giovanbattista	ジョヴァンバッティスタ
Giovanelli	ジョヴァネッリ
Giovannetti	ジョヴァンネッティ
Giovannini	ジョヴァンニーニ
Giraldoni	ジラルドーニ
Girardi	ジラルディ
Girolami	ジローラミ
Giroldini	ジロルディーニ
Giugiaro	ジュジャーロ
Giuliani	ジュリアーニ
Giuliano	ジュリアーノ
Giulietti	ジュリエッティ
Giulio	ジュリオ、ジューリオ
Giunti	ジュンティ
Giusta	ジュスタ
Giusti	ジュスティ
Giustino	ジュスティーノ
Giusto	ジュスト
Gnecchi	ニェッキ
Gobbi	ゴッビ
Goggi	ゴッジ
Goldoni	ゴルドーニ
Golgi	ゴルジ
Golinelli	ゴリネッリ
Gonella	ゴネッラ
Gordigiani	ゴルディジャーニ
Gorini	ゴリーニ
Gottardi	ゴッタルディ
Gotti	ゴッティ
Gozi	ゴーツィ
Gozzi	ゴッツィ
Gramazio	グラマツィオ
Granata	グラナータ
Grandi	グランディ
Grandoni	グランドーニ
Grappelli	グラッペッリ
Grassi	グラッシ
Grasso	グラッソ
Graziani	グラツィアーニ
Graziano	グラツィアーノ
Greco	グレコ、グレーコ
Greggio	グレッジョ
Grieco	グリエコ
Griffi	グリッフィ
Grilli	グリッリ
Grillini	グリッリーニ
Grillo	グリッロ
Grillotti	グリロッティ
Grimaldi	グリマルディ
Grisendi	グリゼンディ
Gronchi	グロンキ
Grossi	グロッシ
Grosso	グロッソ
Guadagni	グアダーニ
Guardi	グアルディ
Guardini	グァルディーニ
Guarini	グアリーニ
Guarino	グアリーノ
Guarneri	グアルネーリ
Guarnieri	グァルニエリ
Gubellini	グベッリーニ
Gucci	グッチ
Guccini	グッチーニ
Gueglio	グエッリョ
Guerra	グエッラ
Guerri	グエールリ、グエッリ
Guerrini	グエッリーニ
Guggia	グッジャ
Guglielmi	グッリェルミ
Guglielminetti	グッリェルミネッティ
Guicciardi	グイッチャルディ
Guicciardini	グイッチャルディーニ
Guidi	グイディ
Gullotta	グッロッタ
Gusella	グゼッラ
Guzzanti	グッツァンティ
Guzzo	グッツォ
Iacopini	ヤコピーニ、イアコピーニ
Iannucci	ヤンヌッチ、イアンヌッチ
Iaquinta	ヤクウィンタ、イアクィンタ
Ilario	イラーリオ
Illuminati	イルミナーティ
Incandela	インカンデラ
Incrocci	インクロッチ
Infascelli	インファシェッリ
Infontino	インフォンティーノ
Ingegneri	インジェニェーリ
Inghilleri	インギッレリ
Innocenti	インノチェンティ
Insana	インサーナ
Insanguine	インサングイネ
Insegno	インセーニョ
Insinna	インシンナ
Interlenghi	インテルレンギ
Inzaghi	インザーギ
Iommi	イオンミ
Isola	イゾラ
Italiano	イタリアーノ
Izzo	イッツォ
Jacchia	ヤッキア
La Camera	ラ・カーメラ
La Ferlita	ラ・フェルリータ
La Marca	ラ・マールカ
La Penna	ラ・ペンナ
La Rocca	ラ・ロッカ
La Rotella	ラ・ロテッラ
La Torre	ラ・トルレ
La Valle	ラ・ヴァッレ
Labia	ラビア
Labriola	ラブリオーラ
Laconi	ラコーニ
Laforese	ラフォレーゼ
Lalla	ラッラ
Lalli	ラッリ
Lamberti	ランベルティ
Lambertini	ランベルティーニ
Lambertucci	ランベルトゥッチ
Lampredi	ランプレディ
Lampugnani	ランプニャーニ
Lana	ラーナ
Lancini	ランチーニ
Landi	ランディ
Landini	ランディーニ
Landriani	ランドリアーニ
Lanfranchi	ランフランキ
Lanotte	ラノッテ
Lanteri	ランテーリ
Lanza	ランツァ
Lanzetta	ランツェッタ
Lattuada	ラットゥアーダ
Laurini	ラウリーニ
Laurito	ラウリート
Lauro	ラウロ
Lavarello	ラヴァレッロ
Lavitrano	ラヴィトラーノ
Lazzari	ラッツァリ、ラッザリ
Lazzarini	ラッツァリーニ
Lazzati	ラッツァーティ
Lazzeroni	ラッツェローニ
Leali	レアーリ
Legnini	レニーニ
Legramanti	レグラマンティ
Legrenzi	レグレンツィ
Legrottaglie	レグロッターリェ
Lelio	レーリオ、レリオ
Lelli	レッリ
Lentini	レンティーニ
Leo	レオ
Leonardi	レオナルディ、レオナールディ
Leoncavallo	レオンカヴァッロ
Leone	レオーネ
Leoni	レオーニ
Leonzio	レオンツィオ
Leopardi	レオパルディ
Leosini	レオジーニ
Lepido	レーピド
Lerici	レーリチ
Lerro	レッロ
Letizia	レティツィア
Liberatore	リベラトーレ
Licata	リカータ
Licinio	リチーニオ
Ligabue	リガブーエ
Ligi	リージ
Lilli	リッリ
Lillo	リッロ
Limarilli	リマリッリ
Lione	リオーネ
Lionelli	リオネッリ
Lionello	リオネッロ
Liorni	リオールニ
Lippi	リッピ
Lissoni	リッソーニ
Litrico	リトリコ
Littizzetto	リッティッツェット
Liverani	リヴェラーニ
Lizzani	リッツァーニ
Lobello	ロベッロ
Locatelli	ロカテッリ
Lodato	ロダト
Lodoli	ロドリ
Logroscino	ログロシーノ
Lolli	ロッリ
Lollobrigida	ロッロブリジダ
Lombardi	ロンバルディ
Lombardo	ロンバールド
Longhi	ロンギ
Longo	ロンゴ
Lorenzetti	ロレンツェッティ
Lorenzi	ロレンツィ
Lorenzin	ロレンツィン
Lorenzini	ロレンツィーニ
Lorenzoni	ロレンツォーニ
Lori	ローリ
Lotta	ロッタ
Lotti	ロッティ
Lovino	ロヴィーノ
Lualdi	ルアルディ
Luardi	ルアルディ
Lucano	ルカーノ
Lucarelli	ルカレッリ
Lucari	ルカーリ
Lucatti	ルカッティ
Lucca	ルッカ
Lucchesi	ルッケージ
Lucchini	ルッキーニ
Lucci	ルッチ
Luccioni	ルッチョーニ
Luchetti	ルケッティ
Lucia	ルーチア
Lucidi	ルチーディ
Lugo	ルーゴ
Luini	ルイーニ
Luise	ルイーゼ
Lunelli	ルネッリ
Lupi	ルーピ
Lupo	ルーポ
Luppi	ルッピ
Lussignoli	ルッシニョーリ
Luttazzi	ルッタッツィ
Luzzaschi	ルッツァスキ
Mabellini	マベッリーニ
Macario	マカーリオ
Maccagni	マッカーニ
Maccarini	マッカリーニ
Macchi	マッキ
Macchietti	マッキエッティ
Maccianti	マッチャンティ
Macciocchi	マッチョッキ
Macheda	マケーダ
Maciocchi	マチョッキ
Maderna	マデールナ
Madia	マーディア
Maestri	マエストリ
Maestrini	マエストリーニ
Maffei	マッフェイ
Maffeo	マッフェオ
Maggi	マッジ
Maggioni	マッジョーニ
Maggiore	マッジョーレ
Magistretti	マジストレッティ
Magli	マッリ
Magliani	マッリャーニ
Maglietta	マッリェッタ
Magnani	マニャーニ
Magrassi	マグラッシ
Magrini	マグリーニ
Mainardi	マイナルディ
Maini	マイーニ
Maisetti	マイゼッティ
Majorana	マヨラーナ
Malasomma	マラゾンマ
Malaspina	マラスピーナ
Maldera	マルデーラ
Maldini	マルディーニ
Malfante	マルファンテ
Malipiero	マリピエーロ
Malpighi	マルピーギ
Maltese	マルテーゼ
Malvestiti	マルヴェスティーティ
Mameli	マメーリ
Mammoliti	マンモリーティ
Mammucari	マンムカリ
Mancini	マンチーニ
Mandarini	マンダリーニ
Mandelli	マンデッリ
Mandis	マンディス
Mandolini	マンドリーニ
Manelli	マネッリ
Manente	マネンテ
Manenti	マネンティ
Manetti	マネッティ
Manfredi	マンフレーディ
Manfredini	マンフレディーニ
Manfredonia	マンフレドーニア
Mangano	マンガノ
Mangiagalli	マンジャガッリ
Mangini	マンジーニ
Manna	マンナ
Mannarini	マンナリーニ
Manni	マンニ
Mannino	マンニーノ
Mannoia	マンノーイア
Mannoni	マンノーニ
Mantelli	マンテッリ
Manti	マンティ
Mantiero	マンティエロ
Mantoni	マントーニ
Mantovani	マントヴァーニ
Manuritta	マヌリッタ
Manzione	マンツィオーネ
Manzocchi	マンゾッキ
Manzoni	マンゾーニ
Maragliano	マラッリャーノ
Maraini	マライーニ
Marangoni	マランゴーニ
Maranini	マラニーニ
Maratta	マラッタ
Maraventano	マラヴェンターノ
Marazzoli	マラッツォーリ
Marcelli	マルチェッリ
Marcello	マルチェッロ
Marchei	マルケイ
Marchese	マルケーゼ
Marchesi	マルケージ
Marchesini	マルケジーニ
Marchetti	マルケッティ
Marchi	マルキ
Marchiandi	マルキアンディ
Marchina	マルキーナ
Marchini	マルキーニ
Marchionne	マルキオンネ
Marchionni	マルキオンニ
Marchisio	マルキージオ
Marciano	マルチャーノ
Marconi	マルコーニ
Marcucci	マルクッチ
Marelli	マレッリ
Marengo	マレンゴ
Marenzio	マレンツィオ
Margaglio	マルガッリョ
Margiotta	マルジョッタ
Mari	マーリ
Mariani	マリアーニ
Marimpietri	マリンピエトリ
Marinelli	マリネッリ
Marinello	マリネッロ
Marineo	マリネオ
Marini	マリーニ
Marino	マリーノ
Marinoni	マリノーニ
Marinuzzi	マリヌッツィ
Mariotti	マリオッティ
Mariucci	マリウッチ
Marliani	マルリアーニ
Maroccolo	マロッコロ
Marotta	マロッタ
Marrone	マルローネ
Marsano	マルサーノ
Martani	マルターニ
Martelli	マルテッリ
Martello	マルテッロ
Marti	マルティ
Martina	マルティーナ
Martinelli	マルティネッリ
Martini	マルティーニ
Martino	マルティーノ
Martinotti	マルティノッティ
Martone	マルトーネ
Martongelli	マルトンジェッリ
Martucci	マルトゥッチ
Marucelli	マルチェッリ
Marzano	マルツァーノ
Marzio	マルツィオ
Marzocca	マルツォッカ
Mascagni	マスカーニ
Mascherini	マスケリーニ
Mascheroni	マスケローニ
Maserati	マゼラーティ
Masetti	マゼッティ
Masi	マージ
Masini	マジーニ
Massa	マッサ
Massari	マッサーリ
Massarini	マッサリーニ
Massaro	マッサーロ
Massetti	マセッティ
Massi	マッシ
Mastelloni	マステッローニ
Mastrangelo	マストランジェロ
Mastroberardino	マストロベラルディーノ
Mastrocinque	マストロチンクウェ
Mastrofrancesco	マストロフランチェスコ
Mastroianni	マストロヤンニ
Mastrojanni	マストロヤンニ
Materazzi	マテラッツィ
Matino	マティーノ
Matruzzi	マトルッツィ
Mattei	マッテーイ
Matteotti	マッテオッティ
Mattero	マッテロ
Matteucci	マッテウッチ
Mattiacci	マッティアッチ
Maugeri	マウジェリ
Mauri	マウリ
Mauro	マウロ
Mazarino	マツァリーノ
Mazza	マッツァ
Mazzacurati	マッツァクラーティ
Mazzantini	マッツァンティーニ
Mazzaroli	マッツァローリ
Mazzatorta	マッツァトルタ
Mazzeo	マッツェオ
Mazzetti	マッツェッティ
Mazzini	マッツィーニ
Mazzocchi	マッゾッキ
Mazzola	マッツォーラ
Mazzolari	マッツォラーリ
Mazzoleni	マッツォレーニ
Mazzoli	マッツォーリ
Mazzone	マッツォーネ
Mazzoni	マッツォーニ
Mazzotta	マッツォッタ
Mazzotti	マッツォッティ
Mazzucato	マッツカート
Meazza	メアッツァ
Mecenate	メチェナーテ
Meconi	メコーニ
Meda	メーダ
Medda	メッダ
Melandri	メランドリ
Melani	メラーニ
Melato	メラート
Melchiorri	メルキオルリ
Meliciani	メリチャーニ
Meloni	メローニ
Melotti	メロッティ
Mendini	メンディーニ
Menegatto	メネガット
Menegon	メネゴン
Mengacci	メンガッチ
Mengoni	メンゴーニ
Mengozzi	メンゴッツィ
Menotti	メノッティ
Merati	メラーティ
Mercadante	メルカダンテ
Mercuriali	メルクリアーリ
Mercurio	メルクリオ
Meridiani	メリディアーニ
Merighetti	メリゲッティ
Merighi	メリーギ
Merini	メリーニ
Merli	メールリ
Meroi	メローイ
Messeri	メッセーリ
Messina	メッシーナ
Mesto	メスト
Meucci	メウッチ
Mezzacapo	メッザカーポ
Mezzapesa	メッザペーサ
Mezzena	メッツェーナ
Michelangeli	ミケランジェリ
Micheli	ミケーリ
Michelino	ミケリーノ
Michetti	ミケッティ
Michielli	ミキエッリ
Miconi	ミコーニ
Migliore	ミッリョーレ
Milanesi	ミラネージ
Milanetti	ミラネッティ
Milani	ミラーニ
Milano	ミラーノ
Milella	ミレッラ
Militello	ミリテッロ
Milone	ミローネ
Minari	ミナーリ
Minervino	ミネルヴィーノ
Minetti	ミネッティ
Minghetti	ミンゲッティ
Mingotti	ミンゴッティ
Mini	ミーニ
Minniti	ミンニーティ
Minore	ミノーレ
Minucci	ミヌッチ
Minutolo	ミヌトーロ
Mirabella	ミラベッラ
Missoni	ミッソーニ
Mocchetti	モッケッティ
Moccia	モッチャ
Modigliani	モディッリャーニ、モディリアーニ
Modotti	モドッティ
Modrone	モドローネ
Modugno	モドゥーニョ
Mogherini	モゲリーニ
Moioli	モイオーリ
Molinari	モリナーリ
Mollino	モッリーノ
Mollo	モッロ
Moltedo	モルテード
Monachesi	モナケージ
Moncalvo	モンカルヴォ
Mondaini	モンダイーニ
Monetti	モネッティ
Monferrato	モンフェルラート
Mongelli	モンジェッリ
Monicelli	モニチェッリ
Monreale	モンレアーレ
Montagna	モンターニャ
Montagnana	モンタニャーナ
Montagnini	モンタニーニ
Montalcini	モンタルチーニ
Montaldo	モンタルド
Montale	モンターレ
Montanari	モンタナーリ
Montanelli	モンタネッリ
Monte	モンテ
Montella	モンテッラ
Montemezzi	モンテメッツィ
Monteriso	モンテリーゾ
Montesanto	モンテサント
Monteverdi	モンテヴェルディ
Montezemolo	モンテゼーモロ
Monti	モンティ
Montini	モンティーニ
Montino	モンティーノ
Morandi	モランディ
Morando	モランド
Moratti	モラッティ
Morelli	モレッリ
Morello	モレッロ
Moreschi	モレスキ
Moretti	モレッティ
Mori	モーリ
Moriero	モリエーロ
Morini	モリーニ
Morlacchi	モルラッキ
Moro	モーロ
Moroni	モローニ
Morotti	モロッティ
Morricone	モッリコーネ
Mortari	モルターリ
Moschino	モスキーノ
Moschitto	モスキット
Mosetti	モゼッティ
Mossali	モッサーリ
Motta	モッタ
Mozzati	モッザーティ
Muccino	ムッチーノ
Mugnone	ムニョーネ
Munari	ムナーリ
Murino	ムリーノ
Muro	ムーロ
Muscio	ムーショ
Musco	ムスコ
Musetti	ムゼッティ
Mussinelli	ムッシネッリ
Mussolini	ムッソリーニ
Muti	ムーティ
Muzio	ムーツィオ
Muzzi	ムッツィ
Naldini	ナルディーニ
Nani	ナーニ
Nanino	ナニーノ
Nannini	ナンニーニ
Napoli	ナーポリ
Napolitano	ナポリターノ
Narciso	ナルチーゾ
Nardi	ナルディ
Nardini	ナルディーニ
Nasolini	ナゾリーニ
Natali	ナターリ
Natta	ナッタ
Nave	ナーヴェ
Negri	ネーグリ
Nencini	ネンチーニ
Nenzi	ネンツィ
Neri	ネーリ
Neroni	ネローニ
Nessi	ネッシ
Nesta	ネスタ
Niccolai	ニッコライ
Niccolini	ニッコリーニ
Nicoletti	ニコレッティ
Nicoli	ニコリ
Nicolini	ニコリーニ
Nicolosi	ニコロージ
Nigrelli	ニグレッリ
Nitti	ニッティ
Nizzi	ニッツィ
Nobile	ノビレ
Nobili	ノビリ
Noli	ノーリ
Noni	ノーニ
Nono	ノーノ
Notalgiacomo	ノタルジャコモ
Notari	ノターリ
Novelli	ノヴェッリ
Nunziata	ヌンツィアータ
Nuvolari	ヌヴォラーリ
Oberti	オベルティ
Occhini	オッキーニ
Odelli	オデッリ
Odorici	オドリーチ
Ogliari	オッリャーリ
Oioli	オイオリ
Oldani	オルダーニ
Oldrini	オルドリーニ
Olive	オリーヴェ
Olivero	オリヴェーロ
Olmi	オルミ
Oltrabella	オルトラベッラ
Onesti	オネスティ
Oppi	オッピ
Oppo	オッポ
Orcagna	オルカーニャ
Orefice	オレーフィチェ
Orengo	オレンゴ
Orfino	オルフィーノ
Oriali	オリアーリ
Orizio	オリツィオ、オリーツィオ
Orlandi	オルランディ
Orlandini	オルランディーニ
Orlando	オルランド
Orlandoni	オルランドーニ
Orsini	オルシーニ
Ossini	オッシーニ
Osti	オスティ
Ottaviani	オッタヴィアーニ
Ottaviano	オッタヴィアーノ
Ottolini	オットリーニ
Pace	パーチェ
Pacetti	パチェッティ
Paci	パーチ
Pacini	パチーニ
Pacino	パチーノ
Pacinotti	パチノッティ
Paciotti	パチョッティ
Padalino	パダリーノ
Padoan	パドアン
Paganella	パガネッラ
Pagani	パガーニ
Paganini	パガニーニ
Pagano	パガーノ
Pagliano	パリヤーノ
Pagliardi	パリャルディ
Pagliaro	パリヤーロ、パッリャーロ
Pagnani	パニャーニ
Paisiello	パイジエッロ
Palazzi	パラッツィ
Palazzolo	パラッツォーロ
Palermiti	パレルミーティ
Palermo	パレルモ
Palestrina	パレストリーナ
Palla	パッラ
Palladio	パッラーディオ
Pallavicino	パルラヴィチーノ
Palma	パルマ
Palmieri	パルミエリ
Palombini	パロンビーニ
Paltrinieri	パルトリニエリ
Palumbo	パルーンボ
Pampanini	パンパニーニ
Panarello	パナレッロ
Pancaro	パンカーロ
Pandolfi	パンドルフィ
Pandolfini	パンドルフィーニ
Pane	パーネ
Panella	パネッラ
Pani	パーニ
Paniccia	パニッチャ
Panico	パニコ
Panizzi	パニッツィ
Pannella	パンネッラ
Panni	パンニ
Pantaleo	パンタレーオ
Pantaleone	パンタレオーネ
Pantaleoni	パンタレオーニ
Pantanelli	パンタネッリ
Pantani	パンターニ
Panucci	パヌッチ
Panzetta	パンツェッタ
Paoletti	パオレッティ
Paoli	パオリ
Paolini	パオリーニ
Paoloni	パオローニ
Papalia	パパーリア
Paparello	パパレッロ
Paperino	パペリーノ
Papi	パーピ
Papini	パピーニ
Paramatti	パラマッティ
Paravicini	パラヴィチーニ
Paravidino	パラヴィディーノ
Parazzini	パラッツィーニ
Parenti	パレンティ
Pareto	パレート
Parini	パリーニ
Paris	パリス
Parise	パリーゼ
Parisi	パリージ
Parmeggiani	パルメジャーニ
Parodi	パローディ
Parola	パローラ
Paroli	パローリ
Parolo	パローロ
Parusso	パルッソ
Parvis	パルヴィス
Pasculli	パスクーリ、パスクッリ
Pasini	パジーニ
Pasolini	パゾリーニ
Pasquali	パスクヮーリ
Pasqualini	パスクヮリーニ
Pasquini	パスクウィーニ、パスクィーニ
Passarelli	パッサレッリ
Passarini	パッサリーニ
Passera	パッセラ
Passeri	パッセリ
Passoni	パッソーニ
Pasta	パスタ
Pastore	パストーレ
Pastori	パストーリ
Patitucci	パティトゥッチ
Patriciello	パトリチェッロ
Patroni	パトローニ
Patti	パッティ
Patuzzi	パトゥッツィ
Pausini	パウジーニ
Pavarini	パヴァリーニ
Pavarotti	パヴァロッティ
Pavesi	パヴェージ
Pavone	パヴォーネ
Pazienza	パツィエンツァ
Pazzini	パッツィーニ
Peano	ペアーノ
Pecchia	ペッキア
Pecci	ペッチ
Pecile	ペチーレ
Pecoraro	ペコラーロ
Pederzini	ペデルツィーニ
Pedone	ペドーネ
Pedrini	ペドリーニ
Pedrollo	ペドロッロ
Pedroni	ペドローニ
Pedrotti	ペドロッティ
Pelizzoli	ペリッツォーリ
Pelle	ペッレ
Pellegri	ペッレグリ
Pellegrinelli	ペッレグリネッリ
Pellegrinetti	ペッレグリネッティ
Pellegrini	ペッレグリーニ
Pellegrino	ペッレグリーノ
Pellico	ペッリコ
Penati	ペナーティ
Pendoli	ペンドリ
Penno	ペンノ
Penta	ペンタ
Pente	ペンテ
Pepe	ペーペ
Peragallo	ペラガッロ
Perazzani	ペラッツァーニ
Perazzini	ペラッツィーニ
Peretti	ペレッティ
Pergolesi	ペルゴレージ
Pergreffi	ペルグレッフィ
Peri	ペーリ
Pericoli	ペリコリ
Perillo	ペリッロ
Perini	ペリーニ
Perosi	ペロージ
Perotti	ペロッティ
Perri	ペルリ
Perrone	ペッローネ
Perrotta	ペッロッタ
Perrotti	ペッロッティ
Perrucchetti	ペルルケッティ
Persiani	ペルシアーニ
Perti	ペルティ
Perticaroli	ペルティカローリ
Pertile	ペルティーレ
Pertini	ペルティーニ
Peruzzi	ペルッツィ
Pesaresi	ペザレジ
Pescara	ペスカーラ
Pescetti	ペシェッティ
Pescucci	ペスクッチ
Pesenti	ペゼンティ
Pessina	ペッシーナ
Pestalozza	ペスタロッツァ
Petracchi	ペトラッキ
Petrassi	ペトラッシ
Petrella	ペトレッラ、ペトレルラ
Petri	ペトリ
Petris	ペトリス
Petruccelli	ペトルチェッリ
Petrucci	ペトルッチ
Petruzzi	ペトルッツィ
Pezzetti	ペッツェッティ
Pezzoli	ペッツォーリ
Pezzolla	ペッツォーラ
Piaggio	ピアッジョ
Piana	ピアーナ
Piangerelli	ピアンジェレッリ
Piazza	ピアッツァ
Piazzera	ピアツェラ
Piazzi	ピアッツィ
Piazzola	ピアッツォーラ
Piazzolla	ピアッツォッラ
Piccaluga	ピッカルーガ
Piccardi	ピッカルディ
Picchi	ピッキ
Piccinini	ピッチニーニ
Piccinni	ピッチンニ
Piccioli	ピッチョーリ
Picco	ピッコ
Piccoli	ピッコリ
Piccolo	ピッコロ
Piccolomini	ピッコローミニ
Picotto	ピコット
Pierantoni	ピエラントーニ
Pieri	ピエリ
Pierini	ピエリーニ
Pietta	ピエッタ
Pignata	ピニャータ
Pigolotti	ピゴロッティ
Pilati	ピラーティ
Pinardi	ピナルディ
Pini	ピーニ
Pinna	ピンナ
Pinotti	ピノッティ
Pinsuti	ピンスーティ
Pinto	ピント
Pinza	ピンツァ
Pinzi	ピンツィ
Piovaccari	ピオヴァッカーリ
Piovani	ピオヴァーニ
Pippi	ピッピ
Pirandello	ピランデッロ
Pirazzini	ピラッツィーニ
Pirlo	ピールロ
Pirovano	ピローヴァノ
Pisano	ピザーノ
Pisanu	ピザーヌ
Piscopo	ピスコポ
Pistarino	ピスタリーノ
Pistelli	ピステッリ
Pistocchi	ピストッキ
Pistorello	ピストレッロ
Pitoni	ピトーニ
Pittaluga	ピッタルーガ
Pittin	ピッティン
Pivano	ピヴァーノ
Pivetti	ピヴェッティ
Pizzardi	ピッツァルディ
Pizzetti	ピッツェッティ
Pizzi	ピッツィ
Pizzo	ピッツォ
Placido	プラチド
Pobbe	ポッベ
Poccetti	ポッチェッティ
Poggi	ポッジ
Poggioli	ポッジョーリ
Pola	ポーラ
Polacco	ポラッコ
Polano	ポラーノ
Poletti	ポレッティ
Poli	ポーリ
Polidoro	ポリドーロ
Polini	ポリーニ
Pollarolo	ポラローロ
Polli	ポッリ
Pollini	ポリーニ
Pollone	ポッローネ
Polo	ポーロ
Polverosi	ポルヴェロージ
Pompilio	ポンピーリオ、ポンピリオ
Pompucci	ポンプッチ
Ponchielli	ポンキエッリ
Ponti	ポンティ
Ponza	ポンツァ
Porcari	ポルカーリ
Porpora	ポルポラ
Porrino	ポリーノ
Porta	ポールタ
Portaluri	ポルタルーリ
Porzano	ポルツァーノ
Postumo	ポストゥモ
Potente	ポテンテ
Potenti	ポテンティ
Pozzi	ポッツィ
Pozzo	ポッツォ
Pozzoli	ポッツォーリ
Pradella	プラデッラ
Prandelli	プランデッリ
Pratella	プラテッラ
Prati	プラーティ
Predieri	プレディエーリ
Presti	プレスティ
Preti	プレーティ
Principini	プリンチピーニ
Procaccini	プロカッチーニ
Prodi	プローディ
Proietti	プロイェッティ
Prosperi	プロースペリ
Protti	プロッティ
Provenzale	プロヴェンツァーレ
Pruzzo	プルッツォ
Pucci	プッチ
Pucciarelli	プッチャレッリ
Puccini	プッチーニ
Pugliese	プッリェーゼ
Puglisi	プリージ
Pugnani	プニャーニ
Pugno	プーニョ
Pulli	プッリ
Pulvirenti	プルヴィレンティ
Puma	プーマ
Quagliarella	クヮッリャレッラ
Quagliato	クヮリヤート
Quaranta	クヮランタ
Quarta	クヮールタ
Quartullo	クヮルトゥッロ
Quasimodo	クヮジモド
Radicati	ラディカーティ
Radice	ラディーチェ
Rafanelli	ラファネッリ
Raffanelli	ラッファネッリ
Raggi	ラッジ
Ragno	ラーニョ
Ragona	ラゴーナ
Raimondi	ライモンディ
Rainaldi	ライナルディ
Raineri	ライネーリ
Ramella	ラメッラ
Rampini	ランピーニ
Randaccio	ランダッチョ
Randi	ランディ
Ranieri	ラニエーリ
Ranocchia	ラノッキア、ラノッキャ
Rapalo	ラパロ
Rapino	ラピーノ
Rasa	ラーザ
Rattalino	ラッタリーノ
Ratti	ラッティ
Rauzzini	ラウッツィーニ
Ravaglia	ラヴァーリャ
Ravanelli	ラヴァネッリ
Ravazzi	ラヴァッツィ
Ravegnini	ラヴェニーニ
Ravelli	ラヴェッリ
Ravinale	ラヴィナーレ
Razzoli	ラッツォリ
Rebecchi	レベッキ
Rebecchini	レベッキーニ
Rebora	レボラ
Redi	レディ
Regge	レッジェ
Reggi	レッジ
Regolini	レゴリーニ
Reguzzoni	レグッツォーニ
Rendano	レンダーノ
Reni	レーニ
Renzi	レンツィ
Reschiglian	レスキーリャン
Respighi	レスピーギ
Restelli	レステッリ
Ribetti	リベッティ
Riboli	リボリ
Ricagno	リカーニョ
Riccardi	リッカルディ
Ricci	リッチ
Ricciardi	リッチャルディ
Ricciarelli	リッチャレッリ
Ricco	リッコ
Ricotti	リコッティ
Rienzo	リエンツォ
Rigacci	リガッチ
Riggieri	リッジェーリ
Righelli	リゲッリ
Righetti	リゲッティ
Righini	リギーニ
Rigoni	リゴーニ
Rigotti	リゴッティ
Rigutto	リグット
Rimini	リミニ
Rimondi	リモンディ
Rinaldi	リナルディ
Rinaudo	リナウド
Rioldi	リオルディ
Ripamonti	リパモンティ
Risaliti	リサリーティ
Risi	リージ、リーシ
Riso	リーゾ
Riva	リーヴァ
Rivalta	リヴァルタ
Rivelli	リヴェッリ
Rivolta	リヴォルタ
Rizzatto	リッツァット
Rizzi	リッツィ
Rizzieri	リッツィエーリ
Rizzo	リッツォ
Rizzoli	リッツォーリ
Robbiati	ロッビアーティ
Roberti	ロベルティ
Rocca	ロッカ
Rocchi	ロッキ
Rocco	ロッコ
Rodigari	ロディガーリ
Roggero	ロッジェロ
Rolandi	ロランディ
Rollero	ロレッロ
Rolli	ロッリ
Romagnoli	ロマニョーリ
Romanelli	ロマネッリ
Romani	ロマーニ
Romano	ロマーノ
Romeo	ロメーオ
Romitelli	ロミテッリ
Ronchi	ロンキ
Rondoni	ロンドーニ
Rontani	ロンターニ
Rore	ローレ
Rosa	ローザ
Rosada	ロザーダ
Rosati	ロザーティ
Rosato	ロザート
Rosi	ロージ、ローシ
Rossellini	ロッセリーニ
Rossetti	ロッセッティ
Rossetto	ロッセット
Rossi	ロッシ
Rossini	ロッシーニ
Rossitto	ロッシット
Rosso	ロッソ
Rota	ロータ
Rotolo	ロトロ
Rovatti	ロヴァッティ
Rovere	ロヴェーレ
Rovighi	ロヴィーギ
Ruberti	ルベルティ
Rubini	ルビーニ
Rucellai	ルチェラーイ
Ruffini	ルッフィーニ
Ruggi	ルッジ
Ruggieri	ルッジェーリ
Ruggiero	ルッジェーロ
Rughetti	ルゲッティ
Ruisi	ルイージ
Rulli	ルッリ
Rullo	ルッロ
Ruopolo	ルオポロ
Russo	ルッソ
Russolo	ルッソロ
Rustico	ルスティコ
Rusticucci	ルスティクッチ
Rutini	ルティーニ
Sabani	サバーニ
Sabatini	サバティーニ
Saccheri	サッケーリ
Sacchetti	サッケッティ
Sacchetto	サッケット
Sacchi	サッキ
Sacchini	サッキーニ
Sacco	サッコ
Saccomani	サッコマーニ
Sacrati	サクラーティ
Sadero	サデーロ
Sala	サーラ
Salati	サラーティ
Saldari	サルダーリ
Salerno	サレルノ
Salieri	サリエリ
Salomone	サロモーネ
Salvadori	サルヴァドーリ
Salvarezza	サルヴァレッツァ
Salvatini	サルヴァティーニ
Salvatori	サルヴァトーリ
Salvi	サルヴィ
Salvini	サルヴィーニ
Salvioni	サルヴィオーニ
Salvo	サルヴォ
Sammarchi	サンマルキ
Sammarelli	サンマレッリ
Sammartini	サンマルティーニ
Samorì	サモリ
Sances	サンチェス
Sanchini	サンキーニ
Sandrelli	サンドレッリ
Sanfilippo	サンフィリッポ
Sanguinetti	サングイネッティ
Sanna	サンナ
Santamaria	サンタマリア
Santangelo	サンタンジェロ
Santarelli	サンタレッリ
Sante	サンテ
Santi	サンティ
Santini	サンティーニ
Santisi	サンティージ
Santo	サント
Santoliquido	サントリクィド
Santoro	サントーロ
Santunione	サントゥニオーネ
Sanzio	サンツィオ
Saraceni	サラチェーニ
Sarcoli	サルコリ
Sarini	サリーニ
Sarro	サッロ
Sartori	サルトーリ
Sartorio	サルトリオ
Sassi	サッシ
Sasso	サッソ
Saturno	サトゥルノ
Savarese	サヴァレーゼ
Savelli	サヴェッリ
Savini	サヴィーニ
Savino	サヴィーノ
Savonarola	サヴォナローラ
Sbarbaro	ズバールバロ
Sbrighi	ズブリーギ
Scabbia	スカッビア
Scacchi	スカッキ
Scacciati	スカッチャーティ
Scaglia	スカッリャ
Scaglietti	スカリエッティ
Scaglione	スカリオーネ
Scalabrini	スカラブリーニ
Scalchi	スカルキ
Scalfaro	スカルファロ
Scalfarotto	スカルファロット
Scandariato	スカンダリアート
Scandiani	スカンディアーニ
Scanzi	スカンツィ
Scanzio	スカンツィオ
Scaratti	スカラッティ
Scarfiotti	スカルフィオッティ
Scarlatti	スカルラッティ
Scarnati	スカルナーティ
Scarpa	スカルパ
Scarpini	スカルピーニ
Scattola	スカットーラ
Scavino	スカヴィーノ
Scavolini	スカヴォリーニ
Scervino	シェルヴィーノ
Scevola	シェーヴォラ
Schiaparelli	スキャパレッリ
Schiavazzi	スキャヴァッツィ
Schiavi	スキャーヴィ
Schiavone	スキャヴォーネ
Schillaci	スキッラチ
Schioppa	スキオッパ
Schipa	スキーパ
Schira	スキーラ
Sciacca	シャーッカ
Sciaccaluga	シャッカルーガ
Scianna	シャンナ
Sciarrino	シャッリーノ
Scionti	ションティ
Scirea	シレア
Sciutti	シュッティ
Scoccimarro	スコッチマーッロ
Scognamiglio	スコニャミッリョ
Scontrino	スコントリーノ
Scotellaro	スコテッラーロ
Scotti	スコッティ
Scotto	スコット
Scozzoli	スコッツォーリ
Scuderi	スクデリ
Sebastiani	セバスティアーニ
Secchi	セッキ
Secci	セッチ
Segantini	セガンティーニ
Segni	セーニ
Selva	セルヴァ
Seminati	セミナーティ
Senise	セニーゼ
Senna	センナ
Serafini	セラフィーニ
Serao	セラオ
Serato	セラート
Serena	セレーナ
Sereni	セレーニ
Sergi	セルジ
Serio	セーリオ
Sermonti	セルモンティ
Serpelloni	セルペッローニ
Serra	セッラ、セールラ
Serracchiani	セルラッキャーニ
Serrao	セルラオ
Serrati	セラーティ
Setaccioli	セタッチョーリ
Settembrini	セッテンブリーニ
Setti	セッティ
Severini	セヴェリーニ
Severino	セヴェリーノ
Sgambati	ズガンバーティ
Sguario	ズグヮーリオ
Siano	シアーノ
Sica	シーカ
Siepi	シエピ
Siffredi	シッフレーディ
Sighele	シーゲレ
Signorelli	シニョレッリ
Signori	シニョーリ
Siliato	シリアート
Silveri	シルヴェーリ
Silvestrelli	シルヴェストレッリ
Silvestri	シルヴェストリ
Simionato	シミオナート
Simona	シモーナ
Simoncelli	シモンチェッリ
Simoncini	シモンチーニ
Simone	シモーネ
Simonetti	シモネッティ
Simonetto	シモネット
Simoni	シモーニ
Sinnone	シノーネ
Sipari	シパーリ
Sirani	シラーニ
Sivori	シヴォリ
Smareglia	ズマレーリャ
Soave	ソアーヴェ
Socci	ソッチ
Sodano	ソダーノ
Soderini	ソデリーニ
Soldano	ソルダーノ
Soldini	ソルディーニ
Solenghi	ソレンギ
Sollecito	ソレチト
Sollima	ソッリーマ
Solmi	ソルミ
Somigli	ソミーリ
Sommella	ソンメッラ
Sonnino	ソンニーノ
Soprani	ソプラーニ
Sordello	ソルデッロ
Soriano	ソリアーノ
Sorrentino	ソルレンティーノ
Sorvino	ソルヴィーノ
Sospiri	ソスピーリ
Spada	スパーダ
Spadaccini	スパダッチーニ
Spadini	スパディーニ
Spallarossa	スパッラロッサ
Spano	スパーノ
Spartaco	スパルタコ
Sperti	スペルティ
Spetrino	スペトリーノ
Spina	スピーナ
Spinazzi	スピナッツィ
Spinelli	スピネッリ
Spinesi	スピネージ
Spizzichino	スピッツィキーノ
Spoltore	スポルトーレ
Spontini	スポンティーニ
Sposini	スポジーニ
Squarcialupi	スクヮルチャルーピ
Squizzato	スクウィッツァート
Staccioli	スタッチョーリ
Staino	スタイノ
Staropoli	スタローポリ
Stazio	スタツィオ
Stecchetti	ステッケッティ
Stecchi	ステッキ
Stefanelli	ステファネッリ
Stefani	ステファーニ
Stella	ステッラ
Stendardi	ステンダルディ
Stignani	スティニャーニ
Stivaletti	スティヴァレッティ
Stoppino	ストッピーノ
Storani	ストラーニ
Storchio	ストルキオ
Strabioli	ストラビオーリ
Stracquadanio	ストラックヮダーニオ
Stradella	ストラデッラ、ストラデルラ
Stradivari	ストラディヴァーリ
Strepponi	ストレッポーニ
Striggio	ストリッジョ
Strina	ストリーナ
Strozzi	ストロッツィ
Stucchi	ストゥッキ
Superti	スペルティ
Surini	スリーニ
Tacchinardi	タッキナルディ
Tacchini	タッキーニ
Tacconi	タッコーニ
Taddei	タッデーイ
Taddia	タッディア
Tadeo	タデオ
Tadolini	タドリーニ
Tafuri	タフーリ
Tagliabue	タリアブーエ、タッリャブーエ
Tagliaferri	タッリャフェッリ
Taglialegne	タッリャレーニェ
Tagliapietra	タッリャピエトラ
Tagliavini	タッリャヴィーニ
Talamanca	タラマンカ
Talarico	タラリーコ
Taliani	タリアーニ
Tamagno	タマーニョ
Tamaro	タマロ
Tambini	タンビーニ
Tancredi	タンクレディ
Tani	ターニ
Tanucci	タヌッチ
Tarantino	タランティーノ
Tarchi	タルキ
Tardelli	タルデッリ
Tarenghi	タレンギ
Tarini	タリーニ
Tarozzi	タロッツィ
Tarquini	タルクィーニ
Tarquinio	タルクウィーニオ
Tartaglia	タルターリャ
Tartini	タルティーニ
Tasca	タスカ
Tassetti	タッセッティ
Tassi	タッシ
Tassinari	タッシナーリ
Tasso	タッソ
Tassotti	タッソッティ
Tavano	タヴァーノ
Taverna	タヴェルナ
Taviani	タヴィアーニ
Tavolazzi	タヴォラッツィ
Tazio	タツィオ、ターツィオ
Tebaldi	テバルディ
Tedeschi	テデスキ
Tedesco	テデスコ
Telesio	テレジオ
Teocoli	テオコリ
Termini	テルミニ
Terranova	テッラノーヴァ
Terzani	テルツァーニ
Tescari	テスカーリ
Tessari	テッサーリ
Tessarini	テッサリーニ
Testa	テスタ
Testino	テスティーノ
Tetrazzini	テトラッツィーニ（テトラツィーニ）
Tibaldi	ティバルディ
Ticozzi	ティコッツィ
Tiepolo	ティエポロ
Tilgher	ティルゲル
Timperi	ティンペーリ
Tipo	ティーポ
Tiraboschi	ティラボスキ
Tiranti	ティランティ
Tirone	ティローネ
Tisci	ティッシ
Titti	ティッティ
Tiziano	ティツィアーノ
Toccafondi	トッカフォンディ
Tocci	トッチ
Todeschini	トデスキーニ
Tofano	トファーノ
Toffolo	トッフォロ
Togliani	トリヤーニ
Togliatti	トリヤッティ
Tognoli	トニョーリ
Tomasi	トマージ
Tomei	トメーイ
Tommasi	トンマージ
Tommasini	トンマジーニ
Tonelli	トネッリ
Toni	トーニ
Tonolo	トーノロ
Tononi	トノーニ
Torelli	トレッリ
Torri	トッリ
Torriani	トッリアーニ、トルリアーニ
Torricelli	トルリチェッリ
Torricini	トッリチーニ
Torrini	トルリーニ
Tosato	トザート
Tosatti	トザッティ
Toscani	トスカーニ
Toscanini	トスカニーニ
Toselli	トゼッリ
Tosi	トージ、トーシ
Tosto	トスト
Totti	トッティ
Tozzi	トッツィ
Trabaci	トラバーチ
Tradati	トラダーティ
Traetta	トラエッタ
Tranquillo	トランクウィッロ
Trapani	トラパーニ
Trasselli	トラッセッリ
Travaglio	トラヴァッリョ
Trecate	トレカーテ
Treccani	トレッカーニ
Tremonti	トレモンティ
Trento	トレント
Tretti	トレッティ
Tribuzio	トリブーツィオ
Tricella	トリチェッラ
Trieste	トリエステ
Trionfera	トリオンフェラ
Tristano	トリスターノ
Tritto	トリット
Troisi	トロイージ
Tromboncino	トロンボンチーノ
Trotta	トロッタ
Trovato	トロヴァート
Trovesi	トロヴェージ
Trussardi	トルッサルディ
Truzzi	トルッツィ
Tucci	トゥッチ
Tullio	トゥーリオ
Turati	トゥラーティ
Turilli	トゥリッリ
Turina	トゥリーナ
Turrini	トゥッリーニ
Uberti	ウベルティ
Uccello	ウッチェッロ
Ungaro	ウンガロ
Urbani	ウルバーニ
Urbano	ウルバーノ
Urbini	ウルビーニ
Usiglio	ウジッリョ
Uttini	ウッティーニ
Uzielli	ウジエッリ
Vacca	ヴァッカ
Vaccai	ヴァッカイ
Vaccarezza	ヴァッカレッツァ
Vaccari	ヴァッカーリ
Vacchi	ヴァッキ
Vaghi	ヴァーギ
Vagnoni	ヴァニョーニ
Vailati	ヴァイラーティ
Valabrega	ヴァラブレーガ
Valarioti	ヴァラリオーティ
Valcepina	ヴァルチェピーナ
Valente	ヴァレンテ
Valenti	ヴァレンティ
Valentini	ヴァレンティーニ
Valentino	ヴァレンティーノ
Valenza	ヴァレンツァ
Valenzi	ヴァレンツィ
Valeri	ヴァレーリ
Valeriano	ヴァレリアーノ
Valiani	ヴァリアーニ
Valignano	ヴァリニャーノ
Valila	ヴァリラ
Valle	ヴァッレ
Valletti	ヴァッレッティ
Valli	ヴァッリ
Vallino	ヴァッリーノ
Valobra	ヴァロブラ
Valori	ヴァローリ
Valsecchi	ヴァルセッキ
Vanelli	ヴァネッリ
Vanni	ヴァンニ
Vanoni	ヴァノーニ
Vanzo	ヴァンツォ
Varese	ヴァレーゼ
Varini	ヴァリーニ
Varrone	ヴァッローネ
Vasari	ヴァザーリ
Vassalli	ヴァッサーリ
Vassallo	ヴァッサッロ
Vatirana	ヴァティラーナ
Vattimo	ヴァッティモ
Vavassori	ヴァヴァッソーリ
Vecchi	ヴェッキ
Vecchio	ヴェッキオ
Vecellio	ヴェチェッリオ
Vella	ヴェッラ
Vena	ヴェーナ
Vendetta	ヴェンデッタ
Venditti	ヴェンディッティ
Veneziani	ヴェネツィアーニ
Ventimiglia	ヴェンティミーリヤ
Vento	ヴェント
Ventola	ヴェントーラ
Ventura	ヴェントゥーラ
Venturini	ヴェントゥリーニ
Veracini	ヴェラチーニ
Verchi	ヴェルキ
Verdi	ヴェルディ
Verdone	ヴェルドーネ
Veretti	ヴェレッティ
Vergani	ヴェルガーニ
Vergassola	ヴェルガッソラ
Vernizzi	ヴェルニッツィ
Veronese	ヴェロネーゼ
Veronesi	ヴェロネージ、ヴェロネーシ
Verri	ヴェッリ、ヴェルリ
Versace	ヴェルサーチェ
Vesentini	ヴェゼンティーニ
Vespa	ヴェースパ
Vezio	ヴェッツィオ
Viadana	ヴィアダーナ
Vialli	ヴィアッリ
Vianello	ヴィアネッロ
Vicari	ヴィカーリ
Vicario	ヴィカーリオ
Vidusso	ヴィドゥッソ
Vieri	ヴィエリ
Vigano	ヴィガーノ
Viganò	ヴィガノ、ヴィガノー
Vighi	ヴィーギ
Vigiani	ヴィジャーニ
Viglione	ヴィッリョーネ
Vignanelli	ヴィニャネッリ
Vignati	ヴィニャーティ
Vignoni	ヴィニョーニ
Villa	ヴィッラ
Villani	ヴィッラーニ
Villoresi	ヴィッロレージ
Vincenti	ヴィンチェンティ
Vinci	ヴィンチ
Vincientino	ヴィンチェンティーノ
Viola	ヴィオーラ
Violano	ヴィオラーノ
Viotti	ヴィオッティ
Viozzi	ヴィオッツィ
Virga	ヴィルガ
Virgilio	ヴィルジーリオ、ヴィルジリオ
Viscardi	ヴィスカルディ
Visconti	ヴィスコンティ
Visentini	ヴィゼンティーニ
Vitale	ヴィターレ
Vitali	ヴィターリ
Vitaliano	ヴィタリアーノ
Viti	ヴィーティ
Vittadini	ヴィッタディーニ
Vivaldi	ヴィヴァルディ
Vivarini	ヴィヴァリーニ
Vivenzi	ヴィヴェンツィ
Viviani	ヴィヴィアーニ
Volpi	ヴォルピ
Volta	ヴォルタ
Volterra	ヴォルテッラ
Zaccarini	ザッカリーニ
Zaccheroni	ザッケローニ
Zagnoni	ザニョーニ
Zambelli	ザンベッリ
Zamboni	ザンボーニ
Zambrotta	ザンブロッタ
Zampaglione	ザンパッリョーネ
Zampedri	ザンペドリ
Zampieri	ザンピエーリ
Zanaboni	ザナボーニ
Zanantoni	ザナントーニ
Zanardi	ザナルディ
Zanasi	ザナージ
Zandonai	ザンドナーイ
Zanella	ザネッラ
Zanetti	ザネッティ
Zani	ザーニ
Zaninello	ザニネッロ
Zanini	ザニーニ
Zanni	ザンニ
Zannini	ザンニーニ
Zanolli	ザノッリ
Zanotti	ザノッティ
Zantedeschi	ザンテデスキ
Zanuso	ザヌーゾ
Zapparoli	ザッパローリ
Zarantonello	ザラントネッロ
Zavattini	ザヴァッティーニ
Zecchillo	ゼッキッロ
Zeffirelli	ゼフィレッリ
Zegna	ゼーニャ
Zelati	ゼラーティ
Zenatti	ゼナッティ
Zenoni	ゼノーニ
Zeppi	ゼッピ
Zerbini	ゼルビーニ
Zerola	ゼローラ
Zichichi	ジキーキ
Ziino	ジーノ
Zilio	ジーリオ、ジリオ
Zilliani	ジリアーニ
Zinetti	ジネッティ
Zingarelli	ジンガレッリ
Zingaretti	ジンガレッティ
Zirpoli	ジルポリ
Zola	ゾーラ
Zoppo	ゾッポ
Zorgniotti	ゾルニオッティ
Zorzi	ゾルズィ
Zuccarini	ズッカリーニ
Zuccaro	ズッカロ
Zucchelli	ズッケッリ、ズッケーリ
Zucchi	ズッキ
Zucconi	ズッコーニ