Aakula	アークラ
Aalto	アールト
Aaltonen	アールトネン
Äärilä	アーリラ
Aarne	アールネ
Aarnio	アールニオ
Aartoma	アールトマ
Aattela	アーッテラ
Aavikko	アーヴィッコ
Ahmaniemi	アハマニエミ
Ahmaoja	アハマオヤ
Ahmavaara	アハマヴァーラ
Aho	アホ
Ahokainen	アホカイネン
Ahokas	アホカス
Ahola	アホラ
Aholainen	アホライネン
Ahonen	アホネン
Ahoniemi	アホニエミ
Ahosilta	アホシルタ
Ahtee	アハテー
Ahtiala	アハティアラ
Ahtila	アハティラ
Ahtisaari	アハティサーリ
Äijälä	アイヤラ
Aikio	アイキオ
Airaksinen	アイラクシネン
Airikkala	アイリッカラ
Airola	アイロラ
Akkanen	アッカネン
Akonniemi	アコンニエミ
Alaja	アラヤ
Alajoki	アラヨキ
Alaluusua	アラルースア
Alanen	アラネン
Alanko	アランコ
Alatalo	アラタロ（アラータロ）
Alho	アルホ
Alhonen	アルホネン
Alhoniemi	アルホニエミ
Alikoski	アリコスキ
Alkula	アルクラ
Almila	アルミラ
Ankelo	アンケロ
Annala	アンナラ
Annukka	アンヌッカ
Antikainen	アンティカイネン
Antila	アンティラ
Anttila	アンッティラ
Anttonen	アンットネン
Arhinmäki	アルヒンマキ
Arho	アルホ
Aro	アロ
Arola	アロラ
Aromaa	アロマー
Aronen	アロネン
Arvonen	アルヴォネン
Asikainen	アシカイネン
Aspi	アスピ
Aspivaara	アスピヴァーラ
Astala	アスタラ
Asunmaa	アスンマー
Aunola	アウノラ
Aunula	アウヌラ
Autio	アウティオ
Autti	アウッティ
Auvinen	アウヴィネン
Ekroos	エクロース（エクルース）
Elomaa	エロマー
Elomo	エロモ
Eloranta	エロランタ
Enho	エンホ
Erkkilä	エルッキラ
Erkko	エルッコ
Erkkola	エルッコラ
Erola	エロラ
Eronen	エロネン
Ervasti	エルヴァスティ
Eskelinen	エスケリネン
Eskola	エスコラ
Etelämäki	エテラマキ
Etelävuori	エテラヴオリ
Evokari	エヴォカリ
Filppula	フィルップラ
Haajanen	ハーヤネン
Haakana	ハーカナ
Haanpää	ハーンパー
Haapakoski	ハーパコスキ
Haapala	ハーパラ
Haapalainen	ハーパライネン
Haapamäki	ハーパマキ
Haapanen	ハーパネン
Haapaniemi	ハーパニエミ
Haapasalo	ハーパサロ
Haapoja	ハーポヤ
Haarala	ハーララ
Haarus	ハールス
Haaskivi	ハースキヴィ
Haatainen	ハータイネン
Haataja	ハータヤ
Haavikko	ハーヴィッコ
Haavisto	ハーヴィスト
Hahli	ハハリ
Hahto	ハハト
Haila	ハイラ
Hakala	ハカラ
Häkämies	ハカミエス
Hakanen	ハカネン
Hakanpää	ハカンパー
Hakkarainen	ハッカライネン
Hakkila	ハッキラ
Häkkinen	ハッキネン
Häkli	ハクリ
Hakola	ハコラ
Hakonen	ハコネン
Hakulinen	ハクリネン
Hakundi	ハクンディ
Halkoaho	ハルコアホ
Halla	ハッラ
Hallio	ハッリオ
Halme	ハルメ
Halmetoja	ハルメトヤ
Halonen	ハロネン
Halttunen	ハルットゥネン
Halvari	ハルヴァリ
Halvoni	ハルヴォニ
Hämäläinen	ハマライネン（ハマーライネン）
Hämeenniemi	ハメーンニエミ
Hanhimäki	ハンヒマキ
Hännenen	ハンネネン
Hännikäinen	ハンニカイネン
Hannikainen	ハンニカイネン
Hannila	ハンニラ
Hänninen	ハンニネン
Hannu	ハンヌ
Hannuksela	ハンヌクセラ
Hannula	ハンヌラ
Hannunen	ハンヌネン
Hanski	ハンスキ
Hanttu	ハンットゥ
Häppölä	ハッポラ
Happonen	ハッポネン
Harakka	ハラッカ
Harala	ハララ
Harikali	ハリカリ
Harikkala	ハリッカラ
Harila	ハリラ
Harinen	ハリネン
Harju	ハルユ
Harjula	ハルユラ
Härkänen	ハルカネン
Harkimo	ハルキモ
Härkin	ハルキン
Harkki	ハルッキ
Härkönen	ハルコネン
Härmä	ハルマ
Härönen	ハロネン
Hartikainen	ハルティカイネン
Hartonen	ハルトネン
Harvala	ハルヴァラ
Hassi	ハッシ
Hassinen	ハッシネン
Hasti	ハスティ
Hasu	ハス
Hatakka	ハタッカ
Hätälä	ハタラ
Hättönen	ハットネン
Hattunen	ハットゥネン
Haukio	ハウキオ
Haukka	ハウッカ
Hauru	ハウル
Hauta-aho	ハウタ＝アホ
Hautala	ハウタラ
Hautamäki	ハウタマキ
Hautaniemi	ハウタニエミ
Haverinen	ハヴェリネン
Havukainen	ハヴカイネン
Häyhä	ハユハ（ヘイヘ）
Häyrynen	ハユリュネン
Heikelä	ヘイケラ
Heikinheimo	ヘイキンヘイモ
Heikkilä	ヘイッキラ
Heikkinen	ヘイッキネン
Heimonen	ヘイモネン
Heinäluoma	ヘイナルオマ
Heinilä	ヘイニラ
Heininen	ヘイニネン
Heino	ヘイノ
Heinola	ヘイノラ
Heinonen	ヘイノネン（ハイノネン）
Heiskanen	ヘイスカネン
Heiskari	ヘイスカリ
Helistö	ヘリスト
Helko	ヘルコ
Helkovaara	ヘルコヴァーラ
Helminen	ヘルミネン
Hentinen	ヘンティネン
Henttonen	ヘンットネン
Hentunen	ヘントゥネン
Herlevi	ヘルレヴィ
Herrala	ヘッララ
Hiekkaranta	ヒエッカランタ
Hietakangas	ヒエタカンナス
Hietala	ヒエタラ
Hietalahti	ヒエタラハティ
Hietamäki	ヒエタマキ
Hietamies	ヒエタミエス
Hietanen	ヒエタネン
Hiidenmaa	ヒーデンマー
Hiidensalo	ヒーデンサロ
Hiidenuhma	ヒーデヌフマ
Hiilelä	ヒーレラ
Hiilesmaa	ヒーレスマー
Hiironen	ヒーロネン
Hilakari	ヒラカリ
Hillilä	ヒッリラ
Hiltula	ヒルトゥラ
Hiltunen	ヒルトゥネン
Himanen	ヒマネン
Himanka	ヒマンカ
Hinkka	ヒンッカ
Hintikka	ヒンティッカ
Hirsi	ヒルシ
Hirvela	ヒルヴェラ
Hirvi	ヒルヴィ
Hirvisaari	ヒルヴィサーリ
Hirvisalo	ヒルヴィサロ
Hirvonen	ヒルヴォネン
Hittavainen	ヒッタヴァイネン
Hiukka	ヒウッカ
Hjerpe	ヒエルペ
Hoikka	ホイッカ
Hokkanen	ホッカネン
Holanti	ホランティ
Holappa	ホラッパ
Holkeri	ホルケリ
Hollo	ホッロ
Holopainen	ホロパイネン
Hölsö	ホルソ
Hongisto	ホンニスト
Honka	ホンカ
Honkanen	ホンカネン
Honkasalo	ホンカサロ
Honkkila	ホンッキラ
Honkonen	ホンコネン
Hookana	ホーカナ
Hörkkö	ホルッコ
Hossi	ホッシ
Hostila	ホスティラ
Houvinen	ホウヴィネン
Hovinen	ホヴィネン
Höykinpuro	ホユキンプロ
Huhta	フフタ
Huhtala	フフタラ
Huhtamo	フフタモ
Huhtanen	フフタネン
Huhtinen	フフティネン
Hulkkonen	フルッコネン
Humalamäki	フマラマキ
Huotari	フオタリ
Huovi	フオヴィ
Huovinen	フオヴィネン
Hupli	フプリ
Hurme	フルメ
Hurmerinta	フルメリンタ
Hurmevaara	フルメヴァーラ
Hurri	フッリ
Hurskainen	フルスカイネン
Hursti	フルスティ
Husu	フス
Huttunen	フットゥネン
Huunonen	フーノネン
Huuskonen	フースコネン
Hynninen	ヒュンニネン
Hynynen	ヒュニュネン
Hyppönen	ヒュッポネン
Hyryläinen	ヒュリュライネン
Hyssälä	ヒュッサラ
Hytönen	ヒュトネン
Hyttinen	ヒュッティネン
Hyvärinen	ヒュヴァリネン
Hyvönen	ヒュヴォネン
Hyypiä	ヒューピア
Hyyppä	ヒューッパ
Hyyrynen	ヒューリュネン
Hyytiä	ヒューティア
Ihalainen	イハライネン
Iho	イホ
Ikäläinen	イカライネン
Ikävalko	イカヴァルコ
Ikola	イコラ
Ikonen	イコネン
Ilola	イロラ
Ilomäki	イロマキ
Ilonen	イロネン
Immanen	インマネン
Immonen	インモネン
Impola	インポラ
Inkeri	インケリ
Inkinen	インキネン
Iso	イソ
Isokallio	イソカッリオ
Isokoski	イソコスキ
Isola	イソラ
Isomäki	イソマキ
Isometsä	イソメッツァ
Isoniemi	イソニエミ
Isorinne	イソリンネ
Isosomppi	イソソンッピ
Isotalo	イソタロ
Itälä	イタラ
Itkonen	イトゥコネン
Jaakkola	ヤーッコラ
Jaakonaho	ヤーコンアホ
Jaakonsaari	ヤーコンサーリ
Jääskeläinen	ヤースケライネン
Jääskö	ヤースコ
Jaatinen	ヤーティネン
Jäätteenmäki	ヤーッテーンマキ
Jakoila	ヤコイラ
Jalava	ヤラヴァ
Jalkanen	ヤルカネン
Jalonen	ヤロネン
Jalosuo	ヤロスオ
Jaloviina	ヤロヴィーナ
Jämsä	ヤムサ
Janhonen	ヤンホネン
Janhunen	ヤンフネン
Jänne	ヤンネ
Jäntti	ヤンッティ
Jantunen	ヤントゥネン
Järä	ヤラ
Jarva	ヤルヴァ
Järvelä	ヤルヴェラ
Järveläinen	ヤルヴェライネン
Järvenpää	ヤルヴェンパー
Järvi	ヤルヴィ
Järvilehto	ヤルヴィレフト
Järvinen	ヤルヴィネン
Järvisalo	ヤルヴィサロ
Jatkuu	ヤトゥクー
Jauho	ヤウホ
Jauhojärvi	ヤウホヤルヴィ
Jäväjä	ヤヴァヤ
Jehkinen	イェフキネン
Joenpalo	ヨエンパロ
Joensuu	ヨエンスー
Jokela	ヨケラ
Jokiaho	ヨキアホ
Jokihaara	ヨキハーラ
Jokilehto	ヨキレフト
Jokinen	ヨキネン
Jokisalo	ヨキサロ
Jouhki	ヨウフキ
Juhana	ユハナ
Jukarainen	ユカライネン
Junnila	ユンニラ
Junttila	ユンッティラ
Juntunen	ユントゥネン
Jussila	ユッシラ
Jussilainen	ユッシライネン
Justinen	ユスティネン
Juteini	ユテイニ
Jutila	ユティラ
Juusela	ユーセラ
Juusola	ユーソラ
Juutilainen	ユーティライネン
Juva	ユヴァ
Juvonen	ユヴォネン
Jylhä	ユルハ
Jyrkiäinen	ユルキアイネン
Kaakkuriniemi	カーックリニエミ
Kääpä	カーパ
Kaappa	カーッパ
Kaarakka	カーラッカ
Kääriäinen	カーリアイネン
Kaarlampi	カールランピ
Kaarlela	カールレラ
Kaartamo	カールタモ
Kaasalainen	カーサライネン
Kaasinen	カーシネン
Kaatra	カートラ
Kähkönen	カハコネン
Kähönen	カホネン
Kaijalainen	カイヤライネン
Kaila	カイラ
Kainulainen	カイヌライネン
Kaipainen	カイパイネン
Kaipio	カイピオ
Kairamo	カイラモ
Kaitainen	カイタイネン
Kaitala	カイタラ
Kaivanto	カイヴァント
Kajala	カヤラ
Käkelä	カケラ
Kakko	カッコ
Kakkola	カッコラ
Kakkonen	カッコネン
Kaksonen	カクソネン
Kalavainen	カラヴァイネン
Kallela	カッレラ
Kalliala	カッリアラ
Kallijärvi	カッリヤルヴィ
Kallinen	カッリネン
Kallio	カッリオ
Kalliokorpi	カッリオコルピ
Kalliokoski	カッリオコスキ
Kalliomäki	カッリオマキ
Kalmi	カルミ
Kaltiainen	カルティアイネン
Kämäräinen	カマライネン
Kämi	カミ
Kamppinen	カンッピネン
Kamu	カム
Kananen	カナネン
Kangas	カンナス
Kangaskorpi	カンナスコルピ
Kangasniemi	カンナスニエミ
Kankaanniemi	カンカーンニエミ
Kankaanpää	カンカーンパー
Kankaanperä	カンカーンペラ
Kankaanranta	カンカーンランタ
Kankaansyrjä	カンカーンシュルヤ
Känkänen	カンカネン
Kankkunen	カンックネン（カンクネン）
Kanniainen	カンニアイネン
Kannisto	カンニスト
Kantee	カンテー
Kantola	カントラ
Kantonen	カントネン
Kapanen	カパネン
Karhi	カルヒ
Karhinen	カルヒネン
Karhu	カルフ
Kari	カリ
Karila	カリラ
Karisalmi	カリサルミ
Karjalainen	カルヤライネン
Kärki	カルキ
Kärkkäinen	カルッカイネン
Kärnä	カルナ
Karpela	カルペラ
Karpinen	カルピネン
Karppinen	カルッピネン
Karttiala	カルッティアラ
Karvinen	カルヴィネン
Karvonen	カルヴォネン
Kasanen	カサネン
Kaski	カスキ
Kaskinen	カスキネン
Kasurinen	カスリネン
Kasvio	カスヴィオ
Kataikko	カタイッコ
Katainen	カタイネン
Kataja	カタヤ
Katajainen	カタヤイネン
Katajisto	カタイスト
Kätkä	カトゥカ
Kattilakoski	カッティラコスキ
Kauhanen	カウハネン
Kaukonen	カウコネン
Kauniainen	カウニアイネン
Kauppi	カウッピ
Kauppila	カウッピラ
Kauppinen	カウッピネン
Kauranen	カウラネン
Kaurismäki	カウリスマキ
Kautonen	カウトネン
Kautto	カウット
Käyhkö	カユフコ
Keinonen	ケイノネン
Kekkonen	ケッコネン
Kellosalmi	ケッロサルミ
Kemiläinen	ケミライネン
Kemppainen	ケンッパイネン（ケムパイネン）
Kemppi	ケンッピ
Kemppinen	ケンッピネン
Kentala	ケンタラ
Keränen	ケラネン
Kervinen	ケルヴィネン
Kesä	ケサ
Kesiö	ケシオ
Keskinarkaus	ケスキナルカウス
Keskinen	ケスキネン
Keskisaari	ケスキサーリ
Keskitalo	ケスキタロ
Keto	ケト
Ketola	ケトラ
Kettu	ケットゥ
Kettunen	ケットゥネン
Keurulainen	ケウルライネン
Kiesi	キエシ
Kiiski	キースキ
Kiiskinen	キースキネン
Kiljunen	キリユネン（キュリーネン）
Kilkka	キルッカ
Killinen	キッリネン
Kilpeläinen	キルペライネン
Kilpi	キルピ
Kilpinen	キルピネン
Kilpivaara	キルピヴァーラ
Kilponen	キルポネン
Kinnunen	キンヌネン
Kippo	キッポ
Kirjarinta	キルヤリンタ
Kirvesniemi	キルヴェスニエミ
Kitinoja	キティノヤ
Kiuru	キウル
Kivari	キヴァリ
Kivekäs	キヴェカス
Kivelä	キヴェラ
Kivi	キヴィ
Kivikoski	キヴィコスキ
Kivilaakso	キヴィラークソ
Kivilahti	キヴィラハティ（キヴィラフティ）
Kivilehto	キヴィレフト
Kivimäki	キヴィマキ
Kivimaki	キヴィマキ
Kivinen	キヴィネン
Kiviniemi	キヴィニエミ（キビニエミ）
Kiviniitty	キヴィニーッテュ
Kivioja	キヴィオヤ
Kiviranta	キヴィランタ
Kivisalo	キヴィサロ
Kivistö	キヴィスト
Klami	クラミ
Kleemola	クレーモラ
Klemelä	クレメラ
Knihtilä	クニヒティラ
Knipi	クニピ
Knuutinen	クヌーティネン
Koho	コホ
Kohonen	コホネン
Koikkalainen	コイッカライネン
Koistinen	コイスティネン
Koivisto	コイヴィスト
Koivu	コイヴ
Koivula	コイヴラ
Koivulahti	コイヴラハティ
Koivulehto	コイヴレフト
Koivumaa	コイヴマー
Koivumäki	コイヴマキ
Koivunen	コイヴネン
Koivuniemi	コイヴニエミ
Koivuranta	コイヴランタ
Koivusaari	コイヴサーリ
Kojonkoski	コヨンコスキ
Kokko	コッコ
Kokkola	コッコラ
Kokkonen	コッコネン
Kolanen	コラネン
Kolehmainen	コレフマイネン
Kolkka	コルッカ
Kolkkala	コルッカラ
Kolttola	コルットラ
Komulainen	コムライネン
Könönen	コノネン
Kononen	コノネン
Kontiola	コンティオラ
Konttinen	コンッティネン
Kontula	コントゥラ
Kopila	コピラ
Koponen	コポネン
Koppala	コッパラ
Korhola	コルホラ
Korhonen	コルホネン
Korjus	コルユス
Korkeaoja	コルケアオヤ
Korpela	コルペラ
Korpelainen	コルペライネン
Korpi	コルピ
Korpijaakko	コルピヤーッコ
Korpikoski	コルピコスキ
Korpinen	コルピネン
Kortekangas	コルテカンナス
Kortesmäki	コルテスマキ
Koskela	コスケラ
Koskelo	コスケロ
Koskenkaiku	コスケンカイク
Koskenmaa	コスケンマー
Koskenniemi	コスケンニエミ
Koskensalo	コスケンサロ
Koski	コスキ
Koskinen	コスキネン
Kosola	コソラ
Kosonen	コソネン
Kostiainen	コスティアイネン
Kosunen	コスネン
Kotamäki	コタマキ
Kotilainen	コティライネン
Kotipelto	コティペルト
Kotisaari	コティサーリ
Kotonen	コトネン
Kottila	コッティラ
Koukka	コウッカ
Kovalainen	コヴァライネン（コバライネン）
Kovanen	コヴァネン
Kuikkonen	クイッコネン
Kuisma	クイスマ
Kuismanen	クイスマネン
Kuitunen	クイトゥネン
Kuivalainen	クイヴァライネン
Kuivanen	クイヴァネン
Kujala	クヤラ
Kukko	クッコ
Kukkola	クッコラ
Kukkonen	クッコネン
Kulmala	クルマラ
Kuloniemi	クロニエミ
Kulovaara	クロヴァーラ
Kulppi	クルッピ
Kunnas	クンナス
Kunnassalo	クンナッサロ
Kuokkanen	クオッカネン
Kuoppala	クオッパラ
Kuosmanen	クオスマネン
Kupari	クパリ
Kuparinen	クパリネン
Kupiainen	クピアイネン
Kurki	クルキ
Kurkinen	クルキネン
Kurri	クッリ（クリ）
Kurvinen	クルヴィネン
Kusmin	クスミン
Kuukkanen	クーッカネン
Kuula	クーラ
Kuusa	クーサ
Kuusela	クーセラ
Kuusi	クーシ
Kuusinen	クーシネン
Kuusisto	クーシスト
Kuuskoski	クースコスキ
Kuusniemi	クースニエミ
Kuustonen	クーストネン
Kykkänen	キュッカネン
Kyläkoski	キュラコスキ
Kyllönen	キュッロネン
Kyllonen	キュッロネン
Kylmänen	キュルマネン
Kymäläinen	キュマライネン
Kynsijarvi	キュンシヤルヴィ
Kyrö	キュロ
Kytölä	キュトラ
Kytönen	キュトネン
Kyttä	キュッタ
Laakkonen	ラーッコネン
Laakso	ラークソ
Laaksonen	ラークソネン
Laari	ラーリ
Laatikainen	ラーティカイネン
Lähde	ラハデ
Lähteenmäki	ラハテーンマキ
Lahtela	ラハテラ
Lahti	ラハティ
Lahtinen	ラハティネン
Lahtomaa	ラハトマー
Laihiala	ライヒアラ
Laiho	ライホ
Laihonen	ライホネン
Laine	ライネ
Lainio	ライニオ
Lairila	ライリラ
Laisto	ライスト
Laitila	ライティラ
Laitinen	ライティネン
Lajunen	ラユネン
Lakanen	ラカネン
Lakomaa	ラコマー
Lallukka	ラッルッカ
Lamminen	ランミネン
Lamminpää	ランミンパー
Lampinen	ランピネン
Lamppi	ランッピ
Lamppinen	ランッピネン
Lamppu	ランップ
Lämpsä	ランプサ
Lampu	ランプ
Lämsä	ラムサ
Lanamäki	ラナマキ
Lankila	ランキラ
Lankinen	ランキネン
Lappalainen	ラッパライネン
Lappo	ラッポ
Lapveteläinen	ラプヴェテライネン
Larivaara	ラリヴァーラ
Lassila	ラッシラ
Latomaa	ラトマー
Laturi	ラトゥリ
Latvala	ラトヴァラ
Laukka	ラウッカ
Laukkanen	ラウッカネン
Laukkinen	ラウッキネン
Laukkonen	ラウッコネン
Laukonen	ラウコネン
Launonen	ラウノネン
Lauri	ラウリ
Laurikainen	ラウリカイネン
Laurila	ラウリラ
Lautala	ラウタラ
Lautasalo	ラウタサロ
Lavinen	ラヴィネン
Lehikoinen	レヒコイネン
Lehkosuo	レフコスオ
Lehotonen	レホトネン
Lehterä	レフテラ
Lehti	レフティ
Lehtimäki	レフティマキ
Lehtinen	レフティネン
Lehtipuu	レフティプー
Lehto	レフト
Lehtokoski	レフトコスキ
Lehtola	レフトラ
Lehtomäki	レフトマキ
Lehtonen	レフトネン
Lehtosaari	レフトサーリ
Lehtosalo	レフトサロ
Lehvonen	レフヴォネン
Leino	レイノ
Leinonen	レイノネン
Leivo	レイヴォ
Leivonen	レイヴォネン
Leminen	レミネン
Lenho	レンホ
Lenkkeri	レンッケリ
Lepistö	レピスト
Lepola	レポラ
Leppä	レッパ
Leppälä	レッパラ
Leppäluoto	レッパルオト
Leppänen	レッパネン
Leskinen	レスキネン
Letonmäki	レトンマキ
Lievonen	リエヴォネン
Lihavainen	リハヴァイネン
Liikanen	リーカネン
Liikkanen	リーッカネン
Liimatainen	リーマタイネン
Likitalo	リキタロ
Lilja	リリヤ
Lindroos	リンドロース
Linjama	リニヤマ
Linko	リンコ
Linkola	リンコラ
Linna	リンナ
Linnainmaa	リンナインマー
Linnapuomi	リンナプオミ
Linnasalo	リンナサロ
Lintala	リンタラ
Lintamo	リンタモ
Lintilä	リンティラ
Lintinen	リンティネン
Lintonen	リントネン
Lintula	リントゥラ
Lintunen	リントゥネン
Linturi	リントゥリ
Lipponen	リッポネン
Liski	リスキ
Litmanen	リトマネン
Liuhala	リウハラ
Liukko	リウッコ
Liukkonen	リウッコネン
Loikkanen	ロイッカネン
Loimaranta	ロイマランタ
Loiri	ロイリ
Lonkainen	ロンカイネン
Lopakka	ロパッカ
Lötjönen	ロトヨネン
Louhisola	ロウヒソラ
Löytty	ロユッテュ
Löyttyniemi	ロユッテュニエミ
Luhtanen	ルフタネン
Luhtasaari	ルフタサーリ
Lukkarinen	ルッカリネン
Lumijärvi	ルミヤルヴィ
Lumivuokko	ルミヴオッコ
Lumme	ルンメ
Luokka	ルオッカ
Luoma	ルオマ
Luopajärvi	ルオパヤルヴィ
Luostarinen	ルオスタリネン
Lusikka	ルシッカ
Luttinen	ルッティネン
Luukka	ルーッカ
Luukkainen	ルーッカイネン
Luukkanen	ルーッカネン
Luukkonen	ルーッコネン
Luusua	ルースア
Lyly	リュリュ
Lylykorpi	リュリュコルピ
Lyyski	リュースキ
Lyytikäinen	リューティカイネン
Lyytinen	リューティネン
Maaniemi	マーニエミ
Maarala	マーララ
Maasalo	マーサロ
Maaskola	マースコラ
Määttä	マーッタ
Madetoja	マデトヤ
Mäenpää	マエンパー
Mäentausta	マエンタウスタ
Maijala	マイヤラ
Maijanen	マイヤネン
Mäkäräinen	マカライネン
Mäkelä	マケラ
Mäkeläinen	マケライネン
Mäki	マキ
Maki	マキ
Mäkilä	マキラ
Mäkinen	マキネン
Mäkipää	マキパー
Mäkitammi	マキタンミ
Makkonen	マッコネン
Malinen	マリネン
Malkamäki	マルカマキ
Mälkki	マルッキ
Malvalehto	マルヴァレフト
Männikkö	マンニッコ
Mannila	マンニラ
Manninen	マンニネン
Mannisenmäki	マンニセンマキ
Männistö	マンニスト
Mansikka	マンシッカ
Mantere	マンテレ
Mantila	マンティラ
Mäntyjärvi	マンテュヤルヴィ
Mäntylä	マンテュラ
Mäntymaa	マンテュマー
Mäntyniemi	マンテュニエミ
Mäntysaari	マンテュサーリ
Marjaana	マルヤーナ
Marjamaa	マルヤマー
Marjaranta	マルヤランタ
Marjo	マルヨ
Markko	マルッコ
Markkula	マルックラ
Markuksela	マルククセラ
Martikainen	マルティカイネン
Martola	マルトラ
Martonen	マルトネン
Marttila	マルッティラ
Marttinen	マルッティネン
Matikainen	マティカイネン
Matinsalo	マティンサロ
Mattila	マッティラ
Mattjus	マッティユス
Maukonen	マウコネン
Mäyrä	マユラ
Melasniemi	メラスニエミ
Merelä	メレラ
Merikanto	メリカント
Merikoski	メリコスキ
Merilahti	メリラハティ
Meriläinen	メリライネン
Meriluoto	メリルオト
Merinen	メリネン
Merta	メルタ
Mertanen	メルタネン
Metsälä	メッツァラ
Metsäraukola	メッツァラウコラ
Mettälä	メッタラ
Mielonen	ミエロネン
Mieto	ミエト
Miettinen	ミエッティネン
Miettunen	ミエットゥネン
Mikkola	ミッコラ
Mikkonen	ミッコネン
Minkkinen	ミンッキネン
Moilanen	モイラネン
Mölsä	モルサ
Mönkäre	モンカレ
Mönkkönen	モンッコネン
Mononen	モノネン
Monto	モント
Möttölä	モットラ（モットーラ）
Muhonen	ムホネン
Muikku	ムイック
Mukka	ムッカ
Multala	ムルタラ
Muokkaa	ムオッカー
Muotka	ムオトゥカ
Murto	ムルト
Murtomaa	ムルトマー
Murtomäki	ムルトマキ
Murtonen	ムルトネン
Mustonen	ムストネン
Mutka	ムトゥカ
Muttilainen	ムッティライネン
Muukkonen	ムーッコネン
Muuri	ムーリ
Muurinen	ムーリネン
Mykrä	ミュクラ
Mylläri	ミュッラリ
Myllylä	ミュッリュラ
Myllyniemi	ミュッリュニエミ
Myllys	ミュッリュス
Myyryläinen	ミューリュライネン
Naalisvaara	ナーリスヴァーラ
Naaralainen	ナーラライネン
Näränen	ナラネン
Närhi	ナルヒ
Närvänen	ナルヴァネン
Nättinen	ナッティネン
Naukkarinen	ナウッカリネン（ナウカリネン）
Nenonen	ネノネン
Nevalainen	ネヴァライネン
Nevonmaa	ネヴォンマー
Niemelä	ニエメラ
Niemi	ニエミ
Nieminen	ニエミネン
Niemisalo	ニエミサロ
Niilola	ニーロラ
Niinikoski	ニーニコスキ
Niinimaa	ニーニマー
Niinistö	ニーニスト
Nikamo	ニカモ
Nikkanen	ニッカネン
Nikkari	ニッカリ
Nikki	ニッキ
Nikkilä	ニッキラ
Nikkola	ニッコラ
Nikula	ニクラ
Nikulainen	ニクライネン
Nimonen	ニモネン
Nirkkonen	ニルッコネン
Niskala	ニスカラ
Niskanen	ニスカネン
Niskavaara	ニスカヴァーラ
Nissilä	ニッシラ
Nissinen	ニッシネン
Nisula	ニスラ
Niukkanen	ニウッカネン
Nokelainen	ノケライネン
Nokkala	ノッカラ
Noronen	ノロネン
Norrena	ノッレナ
Nousiainen	ノウシアイネン
Nummela	ヌンメラ
Nummelin	ヌンメリン（ニュメリン）
Nummi	ヌンミ
Numminen	ヌンミネン
Nuolijärvi	ヌオリヤルヴィ
Nuora	ヌオラ
Nuoranne	ヌオランネ
Nuorela	ヌオレラ
Nurmela	ヌルメラ
Nurmenkari	ヌルメンカリ
Nurmesniemi	ヌルメスニエミ
Nurmi	ヌルミ
Nurminen	ヌルミネン
Nuutinen	ヌーティネン
Nuuttila	ヌーッティラ
Nykänen	ニュカネン
Nyyssönen	ニューッソネン
Oikarinen	オイカリネン
Oinonen	オイノネン
Oittinen	オイッティネン
Oja	オヤ
Ojajärvi	オヤヤルヴィ
Ojala	オヤラ
Ojanen	オヤネン
Ojanperä	オヤンペラ
Ojansuu	オヤンスー
Okkonen	オッコネン
Oksala	オクサラ
Oksanen	オクサネン
Olamo	オラモ
Olkkonen	オルッコネン
Ollanketo	オッランケト
Ollanketto	オッランケット
Olli	オッリ
Ollila	オッリラ
Oramo	オラモ
Orasmaa	オラスマー
Otala	オタラ
Otila	オティラ
Otsamo	オッツァモ
Outinen	オウティネン
Ovaskainen	オヴァスカイネン
Paaja	パーヤ
Paajanen	パーヤネン
Pääkallo	パーカッロ
Paakkanen	パーッカネン
Paakkari	パーッカリ
Paakkinen	パーッキネン
Pääkkönen	パーッコネン
Paananen	パーナネン
Paarma	パールマ
Paasikivi	パーシキヴィ
Paasikoski	パーシコスキ
Paasilinna	パーシリンナ
Paasio	パーシオ
Paasivirta	パーシヴィルタ
Paasivuori	パーシヴオリ
Paaso	パーソ
Paasonen	パーソネン
Päätalo	パータロ
Paatelainen	パーテライネン
Paatelma	パーテルマ
Paatero	パーテロ
Paavilainen	パーヴィライネン
Paavola	パーヴォラ
Paavolainen	パーヴォライネン
Paija	パイヤ
Päivärinta	パイヴァリンタ
Päivinen	パイヴィネン
Pajamäki	パヤマキ
Pajari	パヤリ
Pajarin	パヤリン
Paju	パユ
Pajunen	パユネン
Pakarinen	パカリネン
Pakka	パッカ
Pakkanen	パッカネン
Palen	パレン
Palkki	パルッキ
Pallasmaa	パッラスマー
Palmu	パルム
Palo	パロ
Paloheimo	パロヘイモ
Palojärvi	パロヤルヴィ
Palokangas	パロカンナス
Palolahti	パロラハティ
Palomäki	パロマキ
Palonen	パロネン
Paloniemi	パロニエミ
Paloranta	パロランタ
Palva	パルヴァ
Pälviä	パルヴィア
Panttaja	パンッタヤ
Pantti	パンッティ
Panttila	パンッティラ
Pappila	パッピラ
Parantainen	パランタイネン
Parhaniemi	パルハニエミ
Parhiala	パルヒアラ
Parkajoki	パルカヨキ
Pärkkä	パルッカ
Parkkali	パルッカリ
Parkkari	パルッカリ
Parkkila	パルッキラ
Parkkonen	パルッコネン
Parnela	パルネラ
Parnila	パルニラ
Parpa	パルパ
Parpola	パルポラ
Parsinen	パルシネン
Pärssinen	パルッシネン
Partanen	パルタネン
Parviainen	パルヴィアイネン
Pasanen	パサネン
Patinen	パティネン
Patja	パティヤ
Patrikainen	パトリカイネン
Paumola	パウモラ
Paunu	パウヌ
Pehkonen	ペフコネン
Peippo	ペイッポ
Pekkala	ペッカラ
Pekkanen	ペッカネン
Pekkarinen	ペッカリネン
Pekkola	ペッコラ
Pekkonen	ペッコネン
Pekonen	ペコネン
Pekurinen	ペクリネン
Pelkonen	ペルコネン
Pellinen	ペッリネン
Pellonpää	ペッロンパー（ペロンパー）
Peltola	ペルトラ
Peltomaa	ペルトマー
Peltonen	ペルトネン
Peltoniemi	ペルトニエミ
Peltosaari	ペルトサーリ
Pennanen	ペンナネン
Penninkilampi	ペンニンキランピ
Pentikäinen	ペンティカイネン
Penttala	ペンッタラ
Pentti	ペンッティ
Penttilä	ペンッティラ
Penttinen	ペンッティネン
Perälä	ペララ
Perho	ペルホ
Perkiömäki	ペルキオマキ
Pernu	ペルヌ
Perttilä	ペルッティラ
Perttula	ペルットゥラ
Perunka	ペルンカ
Pesälä	ペサラ
Pesola	ペソラ
Pesonen	ペソネン
Petäjä	ペタヤ
Petelius	ペテリウス
Petosalmi	ペトサルミ
Petteri	ペッテリ
Piekkanen	ピエッカネン
Pielinen	ピエリネン
Pieniniemi	ピエニニエミ
Pietikäinen	ピエティカイネン
Pietilä	ピエティラ
Pihkala	ピヒカラ
Pihlaja	ピヒラヤ
Pihlajamaa	ピヒラヤマー
Pihlajamäki	ピヒラヤマキ
Pihlava	ピヒラヴァ
Piili	ピーリ
Piilonen	ピーロネン
Piira	ピーラ
Piirainen	ピーライネン
Piirinen	ピーリネン
Piiroinen	ピーロイネン
Piironen	ピーロネン
Piirto	ピールト
Pikkarainen	ピッカライネン
Pirhonen	ピルホネン
Pirilä	ピリラ
Pirinen	ピリネン
Pitkäjärvi	ピトゥカヤルヴィ
Pitkämäki	ピトゥカマキ
Pitkanen	ピトゥカネン
Pitkänen	ピトゥカネン
Pitkäranta	ピトゥカランタ
Pohjala	ポホヤラ
Pohjamo	ポホヤモ
Pohjanpalo	ポホヤンパロ
Pohjola	ポホヨラ（ポーヨラ）
Pohjonen	ポホヨネン
Pohtamo	ポホタモ
Pokela	ポケラ
Pokka	ポッカ
Pölkki	ポルッキ
Pölönen	ポロネン
Polvi	ポルヴィ
Porkka	ポルッカ
Portimo	ポルティモ
Porvari	ポルヴァリ
Poutala	ポウタラ
Poutanen	ポウタネン
Poutiainen	ポウティアイネン
Pöyhiä	ポユヒア
Pöykiö	ポユキオ、ポイキオ
Pöyry	ポユリュ
Prättälä	プラッタラ
Prinsila	プリンシラ
Puhakka	プハッカ
Puikkonen	プイッコネン
Puisto	プイスト
Puljula	プリユラ
Pulkkinen	プルッキネン
Pulkku	プルック
Pulli	プッリ
Pulliainen	プッリアイネン
Pullinen	プッリネン
Puolakanaho	プオラカナホ
Puolanne	プオランネ
Purkunen	プルクネン
Pursiainen	プルシアイネン
Pusa	プサ
Pusila	プシラ
Puskala	プスカラ
Pusu	プス
Putaansuu	プターンスー
Putkonen	プトゥコネン
Puttonen	プットネン
Puukka	プーッカ
Puumala	プーマラ
Puumalainen	プーマライネン
Puupera	プーペラ
Puupponen	プーッポネン
Puura	プーラ
Puurula	プールラ
Puurunen	プールネン
Puuska	プースカ
Puustinen	プースティネン
Pylkkänen	ピュルッカネン
Pylkkö	ピュルッコ
Pylvänäinen	ピュルヴァナイネン
Pynnönen	ピュンノネン
Pyykölä	ピューコラ
Pyysalo	ピューサロ
Raatikainen	ラーティカイネン（ラーチカイネン）
Rahikainen	ラヒカイネン
Rahkamo	ラハカモ
Rahkonen	ラハコネン
Rahnasto	ラハナスト
Räihälä	ライハラ
Räikkönen	ライッコネン
Raila	ライラ
Railo	ライロ
Raisanen	ライサネン
Räisänen	ライサネン
Raiski	ライスキ
Raita	ライタ
Raitamaa	ライタマー
Raitanen	ライタネン
Raitio	ライティオ
Rajahuhta	ラヤフフタ
Rajajärvi	ラヤヤルヴィ
Rajala	ラヤラ
Rajamaa	ラヤマー
Rajamäki	ラヤマキ
Ramanen	ラマネン
Rankila	ランキラ
Rannikko	ランニッコ
Ranta	ランタ
Rantala	ランタラ
Rantalainen	ランタライネン
Rantamäki	ランタマキ
Rantanen	ランタネン
Rantasalmi	ランタサルミ
Ranto	ラント
Rapinoja	ラピノヤ
Rapo	ラポ
Rapola	ラポラ
Räsänen	ラサネン
Rasi	ラシ
Rasimus	ラシムス
Rask	ラスク
Räty	ラテュ
Rauhala	ラウハラ
Rauramo	ラウラモ
Rautakorpi	ラウタコルピ
Rautasalo	ラウタサロ
Rautava	ラウタヴァ
Rautavaara	ラウタヴァーラ
Rautiainen	ラウティアイネン
Rautio	ラウティオ
Rautiola	ラウティオラ
Rauvola	ラウヴォラ
Ravila	ラヴィラ
Reho	レホ
Rehula	レフラ
Reinikainen	レイニカイネン
Rekola	レコラ
Rekunen	レクネン
Repo	レポ
Ridanpää	リダンパー
Riekkinen	リエッキネン
Riihijärvi	リーヒヤルヴィ
Riikonen	リーコネン
Riipa	リーパ
Riipinen	リーピネン
Riitijoki	リーティヨキ
Rikala	リカラ
Rikkonen	リッコネン
Rinkinen	リンキネン
Rinne	リンネ
Rintala	リンタラ
Rintanen	リンタネン
Risikko	リシッコ
Risku	リスク
Rislakki	リスラッキ
Rissanen	リッサネン
Ristilä	リスティラ
Ristimäki	リスティマキ
Ristniemi	リストニエミ
Risto	リスト
Ristola	リストラ
Ristolainen	リストライネン
Ritala	リタラ
Ritola	リトラ
Riutta	リウッタ
Roininen	ロイニネン
Roivas	ロイヴァス
Röksä	ロクサ
Romppanen	ロンッパネン
Ronkainen	ロンカイネン
Rönkkö	ロンッコ
Roponen	ロポネン
Roppola	ロッポラ
Rousu	ロウス
Rovanperä	ロヴァンペラ
Rukajärvi	ルカヤルヴィ
Ruoanu	ルオアヌ
Ruoho	ルオホ
Ruohonen	ルオホネン
Ruonavaara	ルオナヴァーラ
Ruonovaara	ルオノヴァーラ
Ruotsalainen	ルオッツァライネン（ルオツァライネン）
Rusanen	ルサネン
Rusko	ルスコ
Ruusu	ルース
Ruutu	ルートゥ
Ryhänen	リュハネン
Ryhtä	リュフタ
Ryömä	リュオマ
Ryösä	リュオサ
Ryti	リュティ
Rytkönen	リュトゥコネン
Ryynänen	リューナネン
Saalasti	サーラスティ
Saarela	サーレラ
Saarenpää	サーレンパー
Saari	サーリ
Saariaho	サーリアホ
Saarijärvi	サーリヤルヴィ
Saarikivi	サーリキヴィ
Saarikko	サーリッコ
Saarinen	サーリネン
Saaristo	サーリスト
Saarto	サールト
Saastamoinen	サースタモイネン
Sadeniemi	サデニエミ
Saijonmaa	サイヨンマー
Saikkonen	サイッコネン
Sainio	サイニオ
Saisio	サイシオ
Sakara	サカラ
Saksa	サクサ
Salama	サラマ
Salli	サッリ
Sallinen	サッリネン
Salmela	サルメラ
Salmelainen	サルメライネン
Salmenhaara	サルメンハーラ
Salmi	サルミ
Salminen	サルミネン
Salo	サロ
Salokorpi	サロコルピ
Salokoski	サロコスキ
Salolainen	サロライネン
Salomaa	サロマー
Salomäki	サロマキ
Salonen	サロネン
Salovaara	サロヴァーラ
Salpa	サルパ
Sankala	サンカラ
Sankari	サンカリ
Sannikka	サンニッカ
Santala	サンタラ
Santapukki	サンタプッキ
Santavuori	サンタヴオリ
Säntti	サンッティ
Sarasoja	サラソヤ
Saraste	サラステ
Sarjala	サルヤラ
Sarkomaa	サルコマー
Sarmanto	サルマント
Sarparanta	サルパランタ
Sartanen	サルタネン
Sasi	サシ
Saukkonen	サウッコネン
Sävelä	サヴェラ
Savijärvi	サヴィヤルヴィ
Savijoki	サヴィヨキ
Savikangas	サヴィカンナス
Savolainen	サヴォライネン
Savonheimo	サヴォンヘイモ
Seikola	セイコラ
Seitamaa	セイタマー
Selänne	セランネ
Sepänmaa	セパンマー
Seppä	セッパ
Seppälä	セッパラ
Seppänen	セッパネン
Seppinen	セッピネン
Setälä	セタラ
Sevänen	セヴァネン
Sievinen	シエヴィネン
Sihvola	シヒヴォラ
Sihvonen	シヒヴォネン
Siikasaari	シーカサーリ
Siikavirta	シーカヴィルタ
Siirala	シーララ
Siitari	シータリ
Siitonen	シートネン
Sillanpää	シッランパー
Siltanen	シルタネン
Silven	シルヴェン
Silvennoinen	シルヴェンノイネン
Similä	シミラ
Simola	シモラ
Simonen	シモネン
Sinervo	シネルヴォ
Sinivaara	シニヴァーラ
Sinkkonen	シンッコネン
Sinnemäki	シンネマキ
Sipilä	シピラ
Sippo	シッポ
Sippola	シッポラ
Sipponen	シッポネン
Sirkiä	シルキア
Sirniö	シルニオ
Sirola	シロラ
Sirviö	シルヴィオ
Sistonen	シストネン
Sivonen	シヴォネン
Skinnari	スキンナリ
Soini	ソイニ
Soininen	ソイニネン
Soininvaara	ソイニンヴァーラ
Solja	ソリヤ
Somervuori	ソメルヴオリ
Sonninen	ソンニネン
Soranen	ソラネン
Sovijärvi	ソヴィヤルヴィ
Starkka	スタルッカ
Stenroos	ステンロース
Suhonen	スホネン
Suitiala	スイティアラ
Sukki	スッキ
Sulkunen	スルクネン
Sumiala	スミアラ
Summanen	スンマネン
Suolahti	スオラハティ
Suomalainen	スオマライネン
Suomela	スオメラ
Suomi	スオミ
Suominen	スオミネン
Suonpää	スオンパー
Suorsa	スオルサ
Suosaari	スオサーリ
Suosalo	スオサロ
Surakka	スラッカ
Sutinen	スティネン
Suutala	スータラ
Suutari	スータリ
Svento	スヴェント
Syrjälä	シュルヤラ
Syrjänen	シュルヤネン
Syrjaniemi	シュルヤニエミ
Syrjävaara	シュルヤヴァーラ
Tähti	タハティ
Tahvanainen	タハヴァナイネン
Taimela	タイメラ
Taina	タイナ
Tainio	タイニオ
Taipale	タイパレ
Taiveaho	タイヴェアホ
Takala	タカラ
Takalo	タカロ
Takamäki	タカマキ
Takatalo	タカタロ
Takki	タッキ
Takko	タッコ
Takkula	タックラ
Talvela	タルヴェラ
Talvitie	タルヴィティエ
Tammilehto	タンミレフト
Tamminen	タンミネン
Tammisalo	タンミサロ
Taneli	タネリ
Tanninen	タンニネン
Tanskanen	タンスカネン
Tapani	タパニ
Tapaninen	タパニネン
Tapiola	タピオラ
Tapionlinna	タピオンリンナ
Tapiovaara	タピオヴァーラ
Tarkki	タルッキ
Tarkkonen	タルッコネン
Taskinen	タスキネン
Tauriainen	タウリアイネン
Teittinen	テイッティネン
Telilä	テリラ
Teljo	テリヨ
Temisevä	テミセヴァ
Temonen	テモネン
Tenhunen	テンフネン
Tenkanen	テンカネン
Tenkula	テンクラ
Terästö	テラスト
Teräväinen	テラヴァイネン
Terho	テルホ
Termonen	テルモネン
Tervaharju	テルヴァハルユ
Tervo	テルヴォ
Tiainen	ティアイネン
Tiensuu	ティエンスー
Tiihonen	ティーホネン
Tiikanen	ティーカネン
Tiilikainen	ティーリカイネン
Tiisanoja	ティーサノヤ
Tiittanen	ティーッタネン
Tikanmäki	ティカンマキ
Tikka	ティッカ
Tikkanen	ティッカネン
Tikkinen	ティッキネン
Timonen	ティモネン
Tirkkonen	ティルッコネン
Tissari	ティッサリ
Toikka	トイッカ
Toivanen	トイヴァネン
Toivenen	トイヴェネン
Toivola	トイヴォラ
Toivonen	トイヴォネン
Tokoi	トコイ
Tolkki	トルッキ（トルキ）
Töllinen	トッリネン
Tolonen	トロネン
Tolsa	トルサ
Tolvanen	トルヴァネン
Tommila	トンミラ
Tompuri	トンプリ
Tonteri	トンテリ
Tonttila	トンッティラ
Toppinen	トッピネン
Törmänen	トルマネン
Törrö	トッロ
Toskala	トスカラ
Tossavainen	トッサヴァイネン
Toukonen	トウコネン
Touronen	トウロネン
Tourunen	トウルネン
Tuhkasaari	トゥフカサーリ
Tuikka	トゥイッカ
Tuimala	トゥイマラ
Tukio	トゥキオ
Tuohimaa	トゥオヒマー
Tuomaala	トゥオマーラ
Tuomainen	トゥオマイネン
Tuomela	トゥオメラ
Tuomi	トゥオミ
Tuomikoski	トゥオミコスキ
Tuominen	トゥオミネン
Tuomioja	トゥオミオヤ
Tuomisto	トゥオミスト
Tuomola	トゥオモラ
Tuovinen	トゥオヴィネン
Turja	トゥルヤ
Turkkila	トゥルッキラ
Turpeinen	トゥルペイネン
Turppa	トゥルッパ
Turtola	トゥルトラ
Turunen	トゥルネン
Tuukkanen	トゥーッカネン
Tuulola	トゥーロラ
Tuuri	トゥーリ
Tykkyläinen	テュッキュライネン
Tynkkynen	テュンッキュネン
Typpö	テュッポ
Uimonen	ウイモネン
Uitto	ウイット
Ukkonen	ウッコネン
Ukonmaanaho	ウコンマーンアホ
Uosukainen	ウオスカイネン
Uotila	ウオティラ
Uppa	ウッパ
Urpilainen	ウルピライネン
Utriainen	ウトリアイネン
Utrio	ウトリオ
Utunen	ウトゥネン
Uusipaikka	ウーシパイッカ
Uusisalmi	ウーシサルミ
Uusitalo	ウーシタロ
Uusitorppa	ウーシトルッパ
Vaahtera	ヴァーハテラ
Väänänen	ヴァーナネン
Vaara	ヴァーラ
Vääräniemi	ヴァーラニエミ
Väätäinen	ヴァータイネン
Väätämöinen	ヴァータモイネン
Vähälä	ヴァハラ
Vähämaa	ヴァハマー
Vähämäki	ヴァハマキ
Vähäsöyrinki	ヴァハソユリンキ
Vainionpää	ヴァイニオンパー
Väinöla	ヴァイノラ
Väisälä	ヴァイサラ
Väisänen	ヴァイサネン
Vaittinen	ヴァイッティネン
Väkelä	ヴァケラ
Vakkila	ヴァッキラ
Vakoniemi	ヴァコニエミ
Valakari	ヴァラカリ
Valavaara	ヴァラヴァーラ
Välilä	ヴァリラ
Välimaa	ヴァリマー
Välimäki	ヴァリマキ
Valjakka	ヴァリヤッカ
Valkama	ヴァルカマ
Valkeapää	ヴァルケアパー
Valkki	ヴァルッキ
Valkonen	ヴァルコネン
Valpola	ヴァルポラ
Valtasaari	ヴァルタサーリ
Valtonen	ヴァルトネン
Vanhala	ヴァンハラ
Vanhanen	ヴァンハネン
Vanhempi	ヴァンヘンピ
Vankkoja	ヴァンッコヤ
Vänni	ヴァンニ
Vanninen	ヴァンニネン
Vanpera	ヴァンペラ
Vänskä	ヴァンスカ
Vapaavuori	ヴァパーヴオリ
Varantola	ヴァラントラ
Varis	ヴァリス
Varjonen	ヴァルヨネン
Varonen	ヴァロネン
Vartia	ヴァルティア
Varto	ヴァルト
Varvio	ヴァルヴィオ
Vasala	ヴァサラ
Vasara	ヴァサラ
Vaskola	ヴァスコラ
Vatanen	ヴァタネン
Vataren	ヴァタレン
Vatoren	ヴァトレン
Vauhkonen	ヴァウフコネン
Väyrynen	ヴァユリュネン
Vehanen	ヴェハネン
Vehkalahti	ヴェフカラハティ
Vehola	ヴェホラ
Vehviläinen	ヴェフヴィライネン
Veitonen	ヴェイトネン
Venäläinen	ヴェナライネン
Verkko	ヴェルッコ
Vesa	ヴェサ
Vesala	ヴェサラ
Vesanen	ヴェサネン
Vesisaari	ヴェシサーリ
Vesterinen	ヴェステリネン
Vetelainen	ヴェテライネン（フェテレイネン）
Viialainen	ヴィーアライネン
Viinanen	ヴィーナネン
Viinikainen	ヴィーニカイネン
Viinikka	ヴィーニッカ
Viitala	ヴィータラ
Viitanen	ヴィータネン（ヴィッタネン）
Vilen	ヴィレン
Viljakainen	ヴィリヤカイネン
Viljamaa	ヴィリヤマー
Viljanen	ヴィリヤネン
Vilkkumaa	ヴィルックマー
Villilä	ヴィッリラ
Vilpponen	ヴィルッポネン
Viren	ヴィレン
Virkki	ヴィルッキ
Virkkunen	ヴィルックネン
Virolainen	ヴィロライネン
Virrankoski	ヴィッランコスキ
Virta	ヴィルタ
Virtanen	ヴィルタネン
Virtaperko	ヴィルタペルコ
Virtaranta	ヴィルタランタ
Vitikkohuhta	ヴィティッコフフタ
Vornanen	ヴォルナネン
Voutilainen	ヴォウティライネン（ヴティライネン）
Vuolanne	ヴオランネ
Vuorela	ヴオレラ
Vuori	ヴオリ
Vuorinen	ヴオリネン
Vuoristo	ヴオリスト
Wäänänen	ヴァーナネン
Waaranperä	ヴァーランペラ
Wäinölä	ヴァイノラ
Wäisänen	ヴァイサネン
Wälkky	ヴァルッキュ
Waltari	ヴァルタリ
Wennäkoski	ヴェンナコスキ
Wentela	ヴェンテラ
Westerinen	ヴェステリネン
Westola	ヴェストラ
Wiippola	ヴィーッポラ
Wiitanen	ヴィータネン
Wiljakainen	ヴィリヤカイネン
Wiljamaa	ヴィリヤマー
Wirkkala	ヴィルッカラ（ヴィルカラ）
Wirkkila	ヴィルッキラ
Wirtanen	ヴィルタネン
Wuori	ヴオリ
Wuorijarvi	ヴオリヤルヴィ
Ylhäinen	ユルハイネン
Yli	ユリ
Ylianttila	ユリアンッティラ（ユリアンティラ）
Ylihärsilä	ユリハルシラ
Ylijärvi	ユリヤルヴィ
Ylimäki	ユリマキ
Ylipulli	ユリプッリ（ユリプリ）
Yliriesto	ユリリエスト
Ylönen	ユロネン（ヨーネン）
Ylöstalo	ユロスタロ
Yrjänä	ユルヤナ