Abascal	アバスカル
Abelardo	アベラルド
Abeyta	アベイタ
Abrego	アブレゴ
Abreu	アブレウ
Abril	アブリル
Acevedo	アセベド
Achúcarro	アチュカルロ
Aconcha	アコンチャ
Acosta	アコスタ
Acuña	アクニャ
Adame	アダメ
Adomo	アドモ
Adorno	アドルノ
Afonso	アフォンソ
Aganzo	アガンソ
Agosto	アゴスト
Aguado	アグアド
Aguayo	アグアージョ
Águilar	アギラル
Aguilera	アギレラ
Aguirre	アギルレ
Ahumada	アウマダ
Alanis	アラニス
Alaniz	アラニス
Alarcón	アラルコン
Alba	アルバ
Albelda	アルベルダ
Albeniz	アルベニス
Alberto	アルベルト
Albiol	アルビオル
Alcaine	アルカイネ
Alcalá	アルカラ
Alcántar	アルカンタル
Alcaraz	アルカラス
Alda	アルダ
Alderete	アルデレテ
Alegría	アレグリア
Alejandro	アレハンドロ
Alemán	アレマン
Alen	アレン
Alesanco	アレサンコ
Alfaro	アルファーロ
Alfonso	アルフォンソ
Alicea	アリセア
Aliques	アリケス
Alkorta	アルコルタ
Almajano	アルマハーノ
Almanza	アルマンサ
Almaraz	アルマラス
Almirón	アルミロン
Almodóvar	アルモドバル
Almonte	アルモンテ
Almunia	アルムニア
Alonso	アロンソ
Alonzo	アロンソ
Altamirano	アルタミラーノ
Alva	アルバ
Alvarado	アルバラード
Álvarez	アルバレス
Álvaro	アルバロ
Alves	アルベス
Amador	アマドル
Amavisca	アマビスカ
Amaya	アマージャ
Ambriz	アンブリス
Amenábar	アメナバール
Amieva	アミエバ
Anaya	アナジャ
Andrade	アンドラデ
Ángel	アンヘル
Ángeles	アンヘレス
Anguiano	アンギアノ
Angulo	アングーロ
Ansola	アンソラ
Antolín	アントリーン
Aparicio	アパリシオ
Apodaca	アポダカ
Aponte	アポンテ
Aragó	アラゴ
Aragón	アラゴン
Arámbarri	アランバルリ
Araña	アラーニャ
Arana	アラーナ
Aranda	アランダ
Aranzabal	アランサバル
Aras	アラス
Araujo	アラウホ
Arbós	アルボス
Arce	アルセ
Archuleta	アルチュレタ
Areces	アレセス
Arellano	アレジャーノ、アレリャーノ
Arenas	アレナス
Arenzana	アレンサナ
Arévalo	アレバロ
Arevalo	アレバロ
Argenso	アルヘンソ
Argenta	アルヘンタ
Arguello	アルゲジョ
Arias	アリアス
Arijita	アリヒタ
Armas	アルマス
Armendáriz	アルメンダリス
Armenta	アルメンタ
Armijo	アルミーホ
Arquer	アルケル
Arredondo	アレドンド
Arregui	アルレギ
Arreola	アルレオラ
Arriaga	アリアガ
Arrieta	アルリエタ、アリエタ
Arriete	アリエテ
Arrizubieta	アルリスビエタ
Arroyo	アロジョ
Arteaga	アルテアガ
Asensio	アセンシオ
Aspe	アスペ
Asquerino	アスケリノ
Astorga	アストルガ
Atalaya	アタラジャ
Atencio	アテンシオ
Aullón	アウジョン
Ávalos	アバロス
Avendaño	アベンダーニョ
Ávila	アビラ
Avilés	アビレス
Ayala	アジャラ
Ayo	アジョ
Azaña	アサーニャ
Aznar	アスナール
Azorín	アソリン
Baca	バカ
Badía	バディア
Badillo	バディジョ
Báez	バエス
Baeza	バエサ
Bahamonde	バーモンデ（バハモンデ）
Bahena	バエナ
Bakero	バケーロ
Balada	バラーダ
Balagueró	バラゲロ
Balandín	バランディン
Balderas	バルデラス
Ballesteros	バジェステロス、バイェステロス
Banda	バンダ
Bandera	バンデラ
Banderas	バンデラス
Bañuelas	バニュエラス
Bañuelos	バニュエロス
Baraja	バラハ
Barajas	バラハス
Barbieri	バルビエーリ
Barceló	バルセロ
Bardem	バルデム
Barela	バレーラ
Barkero	バルケロ
Barragán	バルラガン
Barraza	バルラサ
Barrera	バルレラ
Barreto	バルレート
Barrientos	バルリエントス
Barrios	バルリオス
Batista	バティスタ
Bayo	バジョ
Bayona	バジョナ
Becerra	ベセラ
Begoña	ベゴーニャ
Bejarano	ベハラノ
Belázques	ベラスケス
Belgrano	ベルグラーノ
Belmonte	ベルモンテ
Beltrán	ベルトラン
Benavente	ベナベンテ
Benavides	ベナビデス
Benavídez	ベナビデス
Benedito	ベネディート
Benítez	ベニテス
Benito	ベニート
Bergamín	ベルガミン
Berganza	ベルガンサ
Bermúdez	ベルムデス
Bernabé	ベルナベ
Bernal	ベルナル
Berríos	ベルリオス
Beruti	ベルティ
Bétancourt	ベタンコウルト
Bielsa	ビエルサ
Bilbao	ビルバオ
Blanch	ブランチ
Blanco	ブランコ
Bobone	ボボネ
Bonilla	ボニージャ
Bono	ボノ
Borges	ボルヘス
Borqué	ボルケ
Borrego	ボルレゴ
Bose	ボセ
Botello	ボテジョ
Botero	ボテロ
Bravo	ブラーボ
Bretón	ブレトン
Brio	ブリオ
Briones	ブリオネス
Briseño	ブリセーニョ
Brito	ブリト
Brosa	ブローサ
Brotons	ブロトンス
Brugalla	ブルガジャ
Buades	ブアデス
Buenafuente	ブエナフエンテ
Buendía	ブエンディア
Bueno	ブエノ
Buñuel	ブニュエル
Burgos	ブルゴス
Bustamante	ブスタマンテ
Bustos	ブストス
Butragueño	ブトラゲーニョ
Caballé	カバジェ
Caballero	カバジェロ
Cabán	カバン
Cabanilles	カバニージェス、カバニーリェス
Cabero	カベーロ
Cabezas	カベサス
Cabezón	カベソン
Cabrera	カブレラ
Cadena	カデーナ
Cajal	カハール
Caldera	カルデラ
Calderón	カルデロン
Caldeyro	カルデイロ
Calvillo	カルビジョ
Calvino	カルビノ
Calvo	カルボ
Calzada	カルサダ
Camacho	カマチョ
Camarasa	カマラサ
Camarillo	カマリージョ
Camilo	カミロ
Campa	カンパ
Campo	カンポ
Campos	カンポス
Canabal	カナバル
Canal	カナル
Canales	カナレス
Candelaria	カンデラリア
Cañizares	カニサレス
Cano	カノ
Cantilo	カンティロ
Cantú	カントゥ
Capdevila	カプデビラ
Caraballo	カラバジョ
Carbajal	カルバハル
Cárdenas	カルデナス
Cardona	カルドナ
Carestia	カレスティア
Carillo	カリージョ
Carmona	カルモナ
Carnicer	カルニセル
Caro	カーロ
Carranza	カランサ
Carrasco	カラスコ
Carrasquillo	カラスキージョ
Carreño	カレーニョ
Carreón	カルレオン
Carrera	カルレラ
Carreras	カレラス（カレーラス）
Carrero	カルレロ
Carriedo	カルリエド
Carrillo	カルリージョ
Carrion	カルリオン
Carvajal	カルバハル
Casals	カサルス
Casanova	カサノーバ
Casares	カサレス
Casárez	カサレス
Casas	カーサス
Casero	カセロ
Casillas	カシジャス、カシーヤス
Castañeda	カスタニェーダ
Castedo	カステド
Castellanos	カステジャノス
Castells	カステイス
Castillejo	カスティジェホ
Castillo	カスティージョ、カスティーリョ
Castro	カストロ
Cavazos	カバソス
Cazalilla	カサリジャ
Cazares	カサレス
Cazorla	カソルラ
Ceballos	セバジョス
Cebrián	セブリアン
Cebro	セブロ
Cedillo	セディージョ
Ceja	セハ
Cela	セラ
Centeno	センテーノ
Cepeda	セペダ
Cerdà	セルダ
Cerra	セラ
Cervantes	セルバンテス
Cervántez	セルバンテス
Cervera	セルベラ
César	セサル
Cesco	セスコ
Chacón	チャコン
Chapa	チャパ
Chapi	チャピ
Chavarría	チャバリア
Chávez	チャベス
Chueca	チュエカ
Ciges	シヘス
Cintado	シンタド
Cintrón	シントロン
Cisneros	シスネロス
Clavijo	クラビホ
Cobos	コボス
Cofiño	コフィーニョ
Collado	コジャド
Collazo	コジャーソ
Colón	コロン
Colunga	コルンガ
Comas	コマス
Combarro	コンバロ
Comejo	コメホ
Comellas	コメジャス、コメリャス
Concepción	コンセプシオン
Conde	コンデ
Contesti	コンテスティ
Contreras	コントレーラス
Cordero	コルデーロ
Córdova	コルドバ
Corera	コレラ
Cornejo	コルネホ
Cornet	コルネート
Corona	コロナ
Coronado	コロナード
Corostola	コロストラ
Corral	コラル
Corrales	コラレス
Correa	コルレア
Cortés	コルテス
Cortéz	コルテス
Cortina	コルティナ
Cortis	コルティス
Costa	コスタ
Coto	コト
Cotto	コット
Covarrubias	コバルビアス
Crespo	クレスポ
Cruz	クルス
Cuadra	クアドラ
Cuadrado	クアドラド
Cubedo	クベード
Cubiles	クビレス
Cuellar	クエジャル
Cuervas	クエルバス
Curiel	クリエル
Dalí	ダリ
Dávila	ダビラ
Davino	ダビーノ
Davó	ダボ
Daza	ダサ
de Anda	デ・アンダ
de Jesús	デ・ヘスス
de la Cámara	デ・ラ・カマラ
de los Ríos	デ・ロス・リオス
de Pedro	デ・ペドロ
Defilló	デフィジョ
del Campo	デル・カンポ
del Olmo	デル・オルモ
del Rey	デル・レイ
del Rio	デル・リオ
Delá	デラ
Delacrúz	デラクルス
Delafuente	デラフエンテ
Delagarza	デラガルサ
Delao	デラオ
Delapaz	デラパス
Delarosa	デラロサ
Delatorre	デラトルレ
Deleón	デレオン
Delgadillo	デルガディジョ
Delgado	デルガド
Delibes	デリベス
Delrío	デルリオ
Delvalle	デルバジェ
Dengra	デングラ
Devota	デボタ
Díaz	ディアス
Díez	ディエス
Diges	ディヘス
Dolores	ドローレス
Domingo	ドミンゴ
Domínguez	ドミンゲス
Domínquez	ドミンケス
Donoso	ドノソ
Dorado	ドラード
Duarte	ドゥアルテ
Dueñas	ドゥエニャス
Duque	ドゥケ
Duran	ドゥラン
Echevarría	エチェバリア、エチェバルリア
Echeverría	エチェベリア
Elizalde	エリサルデ
Elizondo	エリソンド
Elola	エローラ
Encina	エンシーナ
Encinar	エンシナル
Encinas	エンシーナス
Engonga	エンゴンガ
Enrique	エンリケ
Enríquez	エンリケス
Erice	エリセ
Escalante	エスカランテ
Escamilla	エスカミジャ
Escarpa	エスカルパ
Escobar	エスコバル
Escobedo	エスコベド
Escudero	エスクデーロ
Esparrtero	エスパルテロ
Esparza	エスパルサ
Espinal	エスピナル
Espinel	エスピネル
Espino	エスピノ
Espinosa	エスピノサ
Espinoza	エスピノサ
Espla	エスプラ
Esquibel	エスキベル
Esquivel	エスキベル
Esteban	エステバン
Esteso	エステソ
Esteve	エステベ
Estévez	エステベス
Estrada	エストラダ
Expósito	エスポシト
Fajardo	ファハルド
Falla	ファジャ
Falque	ファルケ
Farías	ファリアス
Farinos	ファリノス
Feliciano	フェリシアーノ
Fernán	フェルナン
Fernández	フェルナンデス
Ferrandis	フェランディス
Ferreiro	フェレイロ
Ferrer	フェルレル
Ferrero	フェレロ
Fierro	フィエルロ
Figueras	フィゲーラス
Figuereo	フィゲレオ
Figueroa	フィゲロア
Fleta	フレータ
Florentino	フロレンティーノ
Flores	フロレス
Flórez	フロレス
Florido	フロリド
Fonseca	フォンセカ
Fortea	フォルテア
Franco	フランコ
Fresán	フレサン
Frías	フリアス
Fuenllana	フエンジャーナ
Fuentes	フエンテス
Gago	ガゴ
Gaitán	ガイタン
Galán	ガラン
Galarza	ガラルサ
Galdos	ガルドス
Galindo	ガリンド
Gallardo	ガジャルド
Gallegos	ガジェゴス
Gallén	ガジェン
Galván	ガルバン
Galves	ガルベス
Gálvez	ガルベス
Gamboa	ガンボア
Gamez	ガメス
Gaona	ガオナ
Garay	ガライ
García	ガルシア
Garibay	ガリバイ
Garica	ガリカ
Garmendia	ガルメンディア
Garnica	ガルニカ
Garrido	ガルリド
Garza	ガルサ
Garzón	ガルソン
Gasset	ガセト
Gastélum	ガステルム
Gaudí	ガウディ
Gaviola	ガビオラ
Gayo	ガジョ
Gaytán	ガイタン
Gil	ヒル
Giménez	ヒメネス
Giro	ヒロ
Girón	ヒロン
Gispert	ヒスペルト
Godínez	ゴディネス
Godoy	ゴドイ
Gómez	ゴメス
Gonzales	ゴンサレス
González	ゴンサレス
Goya	ゴジャ、ゴヤ
Gracia	グラシア
Gracián	グラシアン
Granado	グラナド
Granados	グラナドス
Granollers	グラノジェルス
Grases	グラセス
Griego	グリエゴ
Grijalva	グリハルバ
Guajardo	グアハルド
Guardado	グアルダド
Guardiola	グアルディオラ
Guerra	ゲルラ
Guerrero	ゲルレロ
Guevara	ゲバラ
Guillen	ギジェン
Güiza	グイサ
Gulin	グリン
Gurendez	グレンデス
Gurule	グルレ
Gutiérrez	グティエレス
Guzmán	グスマン
Halffter	アルッフテル（ハルフテル）
Haro	アロ
Helguera	エルゲラ
Henríquez	エンリケス
Heredia	エレディア
Hermosillo	エルモシージョ
Hermoso	エルモーソ
Hernádez	エルナデス
Hernandes	エルナンデス
Hernández	エルナンデス
Hernando	エルナンド
Herrán	エラン
Herrera	エルレラ
Herrero	エレロ
Hidalgo	イダルゴ
Hierro	イエルロ
Higueras	イゲラス
Hinojosa	イノホサ
Holguín	オルギン
Hoya	オジャ
Huerta	ウエルタ
Hurtado	ウルタード
Ibáñez	イバニェス
Ibarra	イバルラ
Ibarrondo	イバルロンド
Ibarruri	イバルリ
Iglesia	イグレシア
Iglesias	イグレシアス
Ignacio	イグナシオ
Induráin	インドゥライン
Infante	インファンテ
Inglés	イングレース
Iniesta	イニエスタ
Iradier	イラディエル
Iraeta	イラエタ
Iranzo	イランソ
Iriarte	イリアルテ
Iribarne	イリバルネ
Izquierdo	イスキェルド
Jacinto	ハシント
Jaime	ハイメ
Jaimes	ハイメス
Jalón	ハロン
Jalopez	ハロペス
Jambrina	ハンブリナ
Japon	ハポン
Jáquez	ハケス
Jaramillo	ハラミジョ
Jasso	ハッソ
Jiménez	ヒメネス
Jimínez	ヒミネス
Jonás	ホナス
Jordá	ホルダ
Jorge	ホルヘ
Juan	フアン
Juanele	フアネーレ
Juárez	フアレス
Jugo	フーゴ
Jurado	フラド
Laboy	ラボイ
Lafuente	ラフエンテ
Lahulla	ラウージャ（ラウーヤ）
Lara	ララ
Larena	ラレナ
Lario	ラリオ
Larrainzar	ララインサル
Larraya	ララジャ
Larrazabal	ララサバル
Larrocha	ラローチャ
Laureano	ラウレアノ
Laynez	ライネス
Lázaro	ラサロ
Leal	レアル
Lebrón	レブロン
Ledesma	レデスマ
Legaspi	レガスピ
Leiva	レイバ
Lemus	レムス
Lendoiro	レンドイロ
Léon	レオン
León	レオン
Lerma	レルマ
Leyva	レイバ
Lezama	レサマ
Lima	リマ
Limón	リモン
Linares	リナレス
Lira	リラ
Llamas	ジャマス
Llobet	ジョベート
Llompart	ジョンパルト、ヨンパルト
Llorente	ヨレンテ
Lloveras	ジョベラス
Loera	ロエラ
Lomeli	ロメリ
Longoria	ロンゴリア
López	ロペス
Lorca	ロルカ
Lorenzo	ロレンソ
Lovato	ロバト
Loya	ロジャ
Loyola	ロジョラ
Lozada	ロサダ
Lozano	ロサノ
Lucas	ルカス
Lucero	ルセロ
Lucía	ルシア
Lucientes	ルシエンテス
Lucio	ルシオ
Luengo	ルエンゴ
Luevano	ルエバノ
Lugo	ルゴ
Luís	ルイス
Luján	ルハン
Luna	ルナ
Machado	マチャド
Machón	マチョン
Macías	マシアス
Madariaga	マダリアーガ
Madera	マデラ
Madrid	マドリード
Madrigal	マドリガル
Madriguera	マドリゲラ
Maestas	マエスタス
Magaña	マガニャ
Malave	マラベ
Maldonado	マルドナド
Manén	マネン
Manzanares	マンサナレス
Manzanera	マンサネラ
Marchan	マルチャン
Marchena	マルチェナ
Mardones	マルドネス
Mares	マレス
Margallo	マルガージョ
Mari	マリ
Mariano	マリアーノ
Marín	マリーン、マリン
Marjaliza	マルハリサ
Marqués	マルケス
Márquez	マルケス
Marrero	マルレロ
Marroquín	マルロキン
Martí	マルティ
Martín	マルティン
Martínez	マルティネス（マルチネス）
Mascareñas	マスカレニャス
Massana	マッサーナ
Mata	マタ
Mateo	マテオ
Mateos	マテオス
Matías	マティアス
Matos	マトス
Maura	マウラ
Maya	マジャ
Mayorga	マジョルガ
Maza	マサ
Mazquiarán	マスキアラン
Medina	メディナ
Medrano	メドラノ
Mejía	メヒア
Mejías	メヒアス
Meléndez	メレンデス
Melgar	メルガル
Membrado	メンブラード
Mena	メーナ
Menchaca	メンチャカ
Méndez	メンデス
Mendieta	メンディエタ
Mendizábal	メンディサバル
Mendoza	メンドーサ
Menéndez	メネンデス
Menge	メンヘ
Mengíbar	メンヒバル
Meraz	メラス
Mercado	メルカド
Merino	メリノ
Mesa	メサ
Meza	メサ
Milan	ミラン
Milanés	ミラネス
Millan	ミジャン
Miralles	ミラージェス
Miramontes	ミラモンテス
Miranda	ミランダ
Mireles	ミレレス
Miró	ミロ
Mojica	モヒカ
Molina	モリーナ
Mompou	モンポウ
Mondragón	モンドラゴン
Monroy	モンロイ
Montalbán	モンタルバン
Montalvo	モンタルボ
Montaner	モンタネール
Montañez	モンタニェス
Montaño	モンタニョ
Montemayor	モンテマジョル
Montenegro	モンテネグロ
Montes	モンテス
Montesinos	モンテシーノス
Montez	モンテス
Montilla	モンティージャ
Montoya	モントジャ
Mora	モラ
Moral	モラル
Morales	モラレス
Morante	モランテ
Moratinos	モラティーノス
Moreno	モレノ
Morientes	モリエンテス
Morilla	モリジャ
Moro	モロ
Mota	モタ
Movilla	モビージャ
Moya	モジャ
Mudarra	ムダルラ
Múgica	ムーヒカ
Mujica	ムヒカ
Munguía	ムンギア
Munilla	ムニジャ
Munitis	ムニティス
Muñiz	ムニス
Muñoz	ムニョース
Murcia	ムルシア
Murillo	ムリージョ、ムリーリョ
Muro	ムロ
Nadal	ナダル
Nájera	ナヘラ
Naranjo	ナランホ
Narros	ナロス
Narváez	ナルバエス
Nava	ナバ
Navarrete	ナバルレテ
Navarro	ナバルロ
Navas	ナバス
Navascués	ナバスクエス
Navascuéz	ナバスクエス
Nazario	ナサリオ
Negrete	ネグレテ
Negrón	ネグロン
Nemesio	ネメシオ
Nevárez	ネバレス
Nguema	ンゲマ
Nicolás	ニコラス
Nieto	ニエト
Nieves	ニエベス
Niño	ニーニョ
Nissen	ニッセン
Noemí	ノエミ
Nogueira	ノゲイラ
Noriega	ノリエガ
Núñez	ヌニェス
Ocampo	オカンポ
Ocasio	オカシオ
Ochoa	オチョア
Ojeda	オヘダ
Olano	オラーノ
Oliva	オリバ
Olivares	オリバレス
Olivárez	オリバレス
Olivas	オリバス
Olivera	オリベラ
Olivo	オリボ
Olmos	オルモス
Olvera	オルベラ
Ondiviela	オンディビエラ
Ontiveros	オンティベロス
Oquendo	オケンド
Orbaneja	オルバネハ
Ordiales	オルディアレス
Ordóñez	オルドニェス
Orellana	オレジャナ
Orihuela	オリウエラ
Ornelas	オルネラス
Orosco	オロスコ
Oroz	オロス
Orozco	オロスコ
Orta	オルタ
Ortega	オルテガ
Orth	オルト
Ortiz	オルティス
Osorio	オソリオ
Otero	オテロ
Oviés	オビエス
Ozuna	オスナ
Pablo	パブロ
Pablos	パブロス
Pabón	パボン
Pacheco	パチェコ
Paco	パコ
Padilla	パディジャ
Padrón	パドロン
Páez	パエス
Pagan	パガン
Palacios	パラシオス
Palencia	パレンシア
Palma	パルマ
Palomero	パロメロ
Palomino	パロミノ
Palomo	パロモ
Pamplona	パンプロナ
Paniagua	パニアグア
Pantoja	パントハ
Parada	パラダ
Pardo	パルド
Paredes	パレデス
Parejo	パレホ
Parés	パレス
París	パリス
Parra	パルラ
Parramon	パルラモン
Parras	パルラス
Partida	パルティダ
Pascual	パスクアル
Pastor	パストル
Patiño	パティニョ
Paz	パス
Pedraza	ペドラサ
Pedrosa	ペドロサ
Pedroza	ペドロサ
Peiro	ペイロ
Pelaez	ペラエス
Pelayo	ペラジョ
Peña	ペーニャ
Pepita	ペピータ
Perales	ペラレス
Peralta	ペラルタ
Peramos	ペラモス
Perea	ペレア
Pereira	ペレイラ
Peres	ペレス
Pérez	ペレス
Pernía	ペルニーア
Picasso	ピカッソ（ピカソ）
Picazo	ピカソ
Pichardo	ピチャルド
Piña	ピニャ
Pinal	ピナル
Pineda	ピネダ
Pintado	ピンタード
Pintó	ピント
Pinzolas	ピンソラス
Pizarro	ピサロ
Polanco	ポランコ
Polo	ポーロ
Pomés	ポメス
Ponce	ポンセ
Porcel	ポルセル
Porras	ポルラス
Portabella	ポルタベジャ
Portillo	ポルティージョ
Posada	ポサダ
Prada	プラダ
Prado	プラド
Preciado	プレシアド
Prieto	プリエト
Puente	プエンテ
Puga	プガ
Pujol	プホル、プジョル
Pulido	プリド
Puyol	プジョール
Quesada	ケサダ
Quevedo	ケベド
Quezada	ケサダ
Quiñones	キニョネス
Quiñónez	キニョネス
Quintana	キンタナ
Quintanilla	キンタニジャ
Quintero	キンテロ
Quiroga	キローガ
Quiros	キロス
Quiroz	キロス
Rabal	ラバル
Rael	ラエル
Ramírez	ラミレス
Ramón	ラモン
Ramos	ラモス
Rangel	ランヘル
Rascón	ラスコン
Raya	ラジャ
Razo	ラソ
Regalado	レガラド
Reina	レイナ
Rendón	レンドン
Rentería	レンテリア
Requejo	レケホ
Reséndez	レセンデス
Reyes	レジェス
Reyna	レイナ
Reynoso	レイノソ
Riazuelo	リアスエロ
Ribera	リベラ、リベーラ
Rico	リコ
Riera	リエラ
Riesgo	リエスゴ
Rincón	リンコン
Rio	リオ
Riojas	リオハス
Ríos	リオス
Rivadeneyra	リバデネイラ
Rivas	リバス
Rivelles	リベジェス
Rivera	リベラ
Rivero	リベロ
Roa	ロア
Robledo	ロブレド
Robles	ロブレス
Roca	ロカ
Rocha	ロチャ
Rodarte	ロダルテ
Rodes	ロデス
Rodrígez	ロドリヘス
Rodrigo	ロドリーゴ、ロドリゴ
Rodríguez	ロドリゲス
Rodríquez	ロドリケス
Rojas	ロハス
Rojo	ロホ
Roldán	ロルダン
Rolón	ロロン
Romero	ロメロ
Romo	ロモ
Roque	ロケ
Ros	ロス
Rosado	ロサド
Rosales	ロサレス
Rosario	ロサリオ
Rosas	ロサス
Roybal	ロイバル
Ruano	ルアノ
Rubio	ルビオ
Rueda	ルエダ
Ruelas	ルエラス
Ruiz	ルイス
Ruvalcaba	ルバルカバ
Sabicas	サビカス
Sáenz	サエンス
Saiz	サイス
Salas	サラス
Salazar	サラサール
Salcedo	サルセド
Salcido	サルシド
Saldaña	サルダニャ
Saldivar	サルディバル
Sales	サレス
Salgado	サルガド、サルガード
Salinas	サリナス
Samaniego	サマニエゴ
Sanabria	サナブリア
Sanches	サンチェス
Sánchez	サンチェス
Sandoval	サンドバル
Sanlúcar	サンルカル
Santacruz	サンタクルス
Santamaria	サンタマリア
Santana	サンターナ
Santiago	サンティアゴ
Santillán	サンティジャン
Santos	サントス
Sanz	サンス
Sarabia	サラビア
Sarasate	サラサーテ
Sardinero	サルディネロ
Sariñana	サリニャーナ
Sauceda	サウセダ
Saucedo	サウセド
Savater	サバテル
Sedeño	セデニョ
Sedillo	セディジョ
Segarra	セガルラ
Segovia	セゴビア
Segura	セグラ
Segurola	セグロラ
Sempere	センペレ
Sendino	センディノ
Sepúlveda	セプルベダ
Serano	セラノ
Serena	セレーナ
Serna	セルナ
Serra	セルラ
Serrano	セルラノ（セラーノ）
Serrato	セルラト
Serveto	セルベト
Sesé	セセ
Sevilla	セビジャ
Sierra	シエルラ
Silva	シルバ
Silvestre	シルベストレ
Sisneros	シスネロス
Sobrino	ソブリノ
Socías	ソシアス
Solá	ソラ
Solana	ソラナ
Solanas	ソラナス
Solano	ソラノ
Soldevila	ソルデビラ
Solé	ソレ
Soler	ソレル、ソレール
Solés	ソレス
Soleto	ソレト
Solís	ソリス
Soliz	ソリス
Solorio	ソロリオ
Solorzano	ソロルサノ
Sor	ソル
Soria	ソリア
Soriano	ソリアノ
Sorozábal	ソロサバル
Sosa	ソサ
Sotelo	ソテロ
Soto	ソト
Suárez	スアレス
Sune	スネ
Surinach	スリナーチ
Suvisa	スビサ
Tafoya	タフォジャ
Talavante	タラバンテ
Tamayo	タマジョ
Tamez	タメス
Tamudo	タムード
Tapia	タピア
Tarragó	タルラゴ
Tárrega	タルレガ
Tarrés	タルレス
Tejada	テハダ
Tejeda	テヘダ
Tejero	テヘロ
Tellería	テジェリア
Téllez	テジェス
Tello	テジョ
Terán	テラン
Terradas	テラダス
Terradellas	テラデージャス
Terrazas	テラサス
Teruel	テルエル
Tijerina	ティヘリナ
Tirado	ティラド
Toldrá	トルドラ
Toledo	トレド
Tomás	トマス
Toro	トロ
Torrent	トレント
Torres	トルレス
Tórrez	トルレス
Torróba	トルロバ
Torroja	トルロハ（トローハ）
Tortajada	トルタハーダ
Tovar	トバル
Tragó	トラーゴ
Trejo	トレホ
Treviño	トレビニョ
Trueba	トルエバ、トゥルエバ
Trueva	トルエバ
Trujillo	トルヒジョ
Turina	トゥリーナ
Úbeda	ウベダ
Uchitel	ウチテル
Udaeta	ウダエタ
Ugarte	ウガルテ
Ulibarri	ウリバルリ
Ulloa	ウジョア
Unamuno	ウナムーノ
Urbano	ウルバノ
Urbina	ウルビナ
Ureña	ウレニャ
Uriarte	ウリアルテ
Urías	ウリアス
Uribe	ウリベ
Urquiaga	ウルキアガ
Urquiola	ウルキオラ
Urreta	ウレタ
Urrutia	ウルティア
Urzaiz	ウルサイス
Usandizaga	ウサンディサーガ
Vaca	バカ
Valadez	バラデス
Valcarce	バルカルセ
Valderrabano	バルデルラバノ
Valdés	バルデス
Valdez	バルデス
Valdivia	バルディビア
Valencia	バレンシア
Valentín	バレンティン
Valenzuela	バレンスエラ
Valeriano	バレリアノ
Valero	バレロ
Valeron	バレロン
Vales	バレス
Valladares	バジャダレス
Valle	バジェ
Vallejo	バジェホ
Valles	バジェス
Valls	バルス
Valverde	バルベルデ
Vanegas	バネガス
Varela	バレラ
Vargas	バルガス
Vásquez	バスケス
Vázquez	バスケス
Vega	ベーガ
Vela	ベラ
Velasco	ベラスコ
Velásquez	ベラスケス
Velázquez	ベラスケス
Vélez	ベレス
Véliz	ベリス
Velo	ベロ
Venegas	ベネガス
Ventura	ベントゥラ
Vera	ベラ
Verdasco	ベルダスコ
Verdugo	ベルドゥゴ
Verduzco	ベルドゥスコ
Vergara	ベルガラ
Vicario	ビカリオ
Vicente	ビセンテ
Vico	ビコ
Victoria	ビクトリア
Vidal	ビダル
Vidiella	ビディエージャ、ビディエーリャ
Vidriales	ビドリアレス
Viera	ビエラ
Vigil	ビヒル
Vilar	ビラール
Vilariño	ビラリーニョ
Vilhena	ビルエナ
Villa	ビジャ
Villacañas	ビジャカーニャス
Villagómez	ビジャゴメス
Villalobos	ビジャロボス
Villalón	ビジャロン
Villalpando	ビジャルパンド
Villanueva	ビジャヌエバ
Villareal	ビジャレアル
Villarejo	ビジャレホ
Villarreal	ビジャルレアル
Villaseñor	ビジャセニョル
Villaverde	ビジャベルデ
Villegas	ビジェガス
Viñes	ビニェス
Vives	ビーベス、ビベス
Vizcaino	ビスカイーノ
Ximénez	シメネス
Yagüe	ジャグエ
Yanes	ジャネス
Yáñez	ジャニェス
Ybarra	イバラ、イバルラ
Yepes	ジェーペス
Yuste	ジュステ
Zabaleta	サバレタ
Zabara	サバラ
Zafra	サフラ
Zambrano	サンブラノ
Zamora	サモラ
Zamudio	サムディオ
Zapata	サパタ
Zapatero	サパテロ
Zaragoza	サラゴサ
Zarate	サラテ
Zavala	サバラ
Zayas	サジャス
Zelaya	セラジャ
Zepeda	セペダ
Zevallos	セバージョス、セバーリョス
Ziganda	シガンダ
Zorrilla	ソリジャ
Zuazo	スアソ
Zubizarreta	スビサレタ
Zúñiga	スニガ
Zurbarán	スルバラン