Abeska	アベスカ
Abík	アビーク
Abrahám	アブラハーム
Abrahamčík	アブラハムチーク
Abrahámek	アブラハーメク
Absolon	アプソロン
Adamčík	アダムチーク
Adamec	アダメツ
Adámek	アダーメク
Adamík	アダミーク
Adamovič	アダモヴィチュ
Adamovský	アダモフスキー
Adášek	アダーシェク
Alexa	アレクサ
Ambrož	アンブロシュ
Anděl	アンジェル
Andrlík	アンドルリーク
Andrš	アンドルシュ
Andrýsek	アンドリーセク
Antoš	アントシュ
Babák	ババーク
Babický	バビツキー
Babka	バプカ
Baborák	バボラーク
Bača	バチャ
Báča	バーチャ
Bačík	バチーク
Bajgar	バイガル
Bakeš	バケシュ
Balák	バラーク
Baláš	バラーシュ
Baláž	バラーシュ
Balcar	バルツァル
Balcárek	バルツァーレク
Bálek	バーレク
Balek	バレク
Balík	バリーク
Balvín	バルヴィーン
Baráček	バラーチェク
Barák	バラーク
Baránek	バラーネク
Bareš	バレシュ
Bařina	バジナ
Bařinka	バジンカ
Baroš	バロシュ
Bárta	バールタ
Barták	バルターク
Bártek	バールテク
Bartek	バルテク
Bartík	バルチーク
Bartl	バルトル
Bartoň	バルトン
Bartoněk	バルトニェク
Bartoníček	バルトニーチェク
Bartoš	バルトシュ
Bartošek	バルトシェク
Bartošík	バルトシーク
Bartůněk	バルトゥーニェク
Bartušek	バルトゥシェク
Bašta	バシュタ
Bastl	バストル
Batěk	バチェク
Bažant	バジャント
Bečka	ベチュカ
Bečvář	ベチュヴァーシュ
Bednář	ベドナーシュ
Bednařík	ベドナジーク
Běhal	ビェハル
Běhounek	ビェホウネク
Bejček	ベイチェク
Bělík	ビェリーク
Bělka	ビェルカ
Bělohlávek	ビェロフラーヴェク
Bém	ベーム
Benák	ベナーク
Bendík	ベンディーク
Beneš	ベネシュ
Benešov	ベネショフ
Beníšek	ベニーシェク
Beránek	ベラーネク
Berdych	ベルディフ
Berka	ベルカ
Berky	ベルキ
Bernášek	ベルナーシェク
Bezděk	ベズジェク
Bezdíček	ベズディーチェク
Bílek	ビーレク
Bilík	ビリーク
Bílý	ビーリー
Bína	ビーナ
Bláha	ブラーハ
Blahuta	ブラフタ
Blažej	ブラジェイ
Blažek	ブラジェク
Bobek	ボベク
Boček	ボチェク
Bocek	ボツェク
Bodlák	ボドラーク
Boháč	ボハーチュ
Boháček	ボハーチェク
Bohata	ボハタ
Bohatý	ボハティー
Bohuslav	ボフスラフ
Bolek	ボレク
Borák	ボラーク
Borecký	ボレツキー
Borek	ボレク
Bořil	ボジル
Borovec	ボロヴェツ
Borovička	ボロヴィチュカ
Borovka	ボロフカ
Borovský	ボロフスキー
Borský	ボルスキー
Borůvka	ボルーフカ
Bosák	ボサーク
Bošek	ボシェク
Botek	ボテク
Bouček	ボウチェク
Bouda	ボウダ
Bouška	ボウシュカ
Bouzek	ボウゼク
Božek	ボジェク
Brabec	ブラベツ
Brabenec	ブラベネツ
Brada	ブラダ
Bradáč	ブラダーチュ
Bravenec	ブラヴェネツ
Brázda	ブラーズダ
Brázdil	ブラーズディル
Břečka	ブシェチュカ
Brejcha	ブレイハ
Březina	ブシェズィナ
Břicháček	ブシハーチェク
Bříza	ブシーザ
Brodský	ブロツキー
Brokeš	ブロケシュ
Brouček	ブロウチェク
Brož	ブロシュ
Brožek	ブロジェク
Brožík	ブロジーク
Brůha	ブルーハ
Brunclík	ブルンツリーク
Brůžek	ブルージェク
Brzák	ブルザーク
Brzobohatý	ブルゾボハティー
Bubeníček	ブベニーチェク
Bubeník	ブベニーク
Bublík	ブブリーク
Buček	ブチェク
Buchta	ブフタ
Budík	ブディーク
Budín	ブディーン
Budinský	ブディンスキー
Budský	ブツキー
Bukáček	ブカーチェク
Bukovský	ブコフスキー
Bulíček	ブリーチェク
Bulín	ブリーン
Burda	ブルダ
Bureš	ブレシュ
Buriánek	ブリアーネク
Buřič	ブジチュ
Bursa	ブルサ
Buršík	ブルシーク
Bursík	ブルシーク
Bušek	ブシェク
Bůžek	ブージェク
Buzek	ブゼク
Bydžovský	ビドジョフスキー
Byrtus	ビルトゥス
Bystřický	ビスッチツキー
Bystroň	ビストロン
Čada	チャダ
Čadek	チャデク
Caha	ツァハ
Čajka	チャイカ
Caletka	ツァレトカ
Čáp	チャープ
Čapek	チャペック、チャペク
Čapka	チャプカ
Carda	ツァルダ
Čáslavský	チャースラフスキー
Částka	チャーストカ
Čech	チェフ
Čechák	チェハーク
Čechura	チェフラ
Čejka	チェイカ
Cejpek	ツェイペク
Čekal	チェカル
Čelůstka	チェルーストカ
Čepek	チェペク
Čepelák	チェペラーク
Čermák	チェルマーク
Černík	チェルニーク
Černoch	チェルノフ
Černohorský	チェルノホルスキー
Černošek	チェルノシェク
Černý	チェルニー
Čeřovský	チェジョフスキー
Červeňák	チェルヴェニャーク
Červenka	チェルヴェンカ
Červený	チェルヴェニー
Červinka	チェルヴィンカ
Češka	チェシュカ
Čevela	チェヴェラ
Chadima	ハディマ
Chaloupka	ハロウプカ
Charvát	ハルヴァート
Chládek	フラーデク
Chlumský	フルムスキー
Chlup	フルプ
Chmel	フメル
Chmela	フメラ
Chmelař	フメラシュ
Chmelíček	フメリーチェク
Chmelík	フメリーク
Chocholouš	ホホロウシュ
Chovanec	ホヴァネツ
Chrástek	フラーステク
Chromý	フロミー
Chudoba	フドバ
Chudý	フディー
Chvála	フヴァーラ
Chvátal	フヴァータル
Chvojka	フヴォイカ
Chytil	ヒチル
Cibulka	ツィブルカ
Cigánek	ツィガーネク
Čihák	チハーク
Číhal	チーハル
Cihlář	ツィフラーシュ
Čipera	チペラ
Císař	ツィーサシュ
Číž	チーシュ
Čížek	チージェク
Crha	ツルハ
Čtvrtečka	チュトヴルテチュカ
Čtvrtník	チュトヴルトニーク
Čuda	チュダ
Culek	ツレク
Čurda	チュルダ
Čureja	チュレヤ
Cvrček	ツヴルチェク
Daněk	ダニェク
Daňhel	ダンヘル
Daníček	ダニーチェク
Danihel	ダニヘル
Daniš	ダニシュ
Davídek	ダヴィーデク
Dědek	ジェデク
Dedek	デデク
Dědič	ジェディチュ
Dejmek	デイメク
Demeter	デメテル
Diblík	ディブリーク
Dítě	ディーチェ
Diviš	ディヴィシュ
Dlouhý	ドロウヒー
Dluhoš	ドルホシュ
Dobeš	ドベシュ
Dobiáš	ドビアーシュ
Dobrovolný	ドブロヴォルニー
Dobrý	ドブリー
Dočekal	ドチェカル
Dočkal	ドチュカル
Dohnal	ドフナル
Dohnálek	ドフナーレク
Dokoupil	ドコウピル
Dolák	ドラーク
Dolanský	ドランスキー
Doleček	ドレチェク
Dolejš	ドレイシュ
Dolejší	ドレイシー
Doležal	ドレジャル
Doležel	ドレジェル
Donát	ドナート
Dopita	ドピタ
Dorazil	ドラズィル
Dorňák	ドルニャーク
Doseděl	ドセジェル
Došek	ドシェク
Doskočil	ドスコチル
Dostál	ドスタール
Dostálek	ドスターレク
Doubek	ドウベク
Doubrava	ドウブラヴァ
Doubravský	ドウブラフスキー
Douda	ドウダ
Douša	ドウシャ
Dráb	ドラープ
Drábek	ドラーベク
Dragoun	ドラゴウン
Drahoňovský	ドラホニョフスキー
Drahoš	ドラホシュ
Drapák	ドラパーク
Drápal	ドラーパル
Drápela	ドラーペラ
Drbohlav	ドルボフラフ
Drda	ドルダ
Drexler	ドレクスレル
Dřímal	ドジーマル
Drlík	ドルリーク
Drobný	ドロブニー
Drtikol	ドルチコル
Dubec	ドゥベツ
Dubský	ドゥプスキー
Ducháček	ドゥハーチェク
Duchek	ドゥヘク
Duchoň	ドゥホン
Dudek	ドゥデク
Dufek	ドゥフェク
Dunka	ドゥンカ
Dušek	ドゥシェク
Dušík	ドゥシーク
Dvořáček	ドヴォジャーチェク
Dvořák	ドヴォジャーク（ドヴォルザーク）
Dvorský	ドヴォルスキー
Eliáš	エリアーシュ
Fabián	ファビアーン
Fabiánek	ファビアーネク
Fabík	ファビーク
Falta	ファルタ
Faltýnek	ファルティーネク
Farkaš	ファルカシュ
Farský	ファルスキー
Fedák	フェダーク
Fejfar	フェイファル
Fencl	フェンツル
Ferenc	フェレンツ
Fiala	フィアラ
Fialka	フィアルカ
Fibich	フィビフ
Ficek	フィツェク
Filák	フィラーク
Filip	フィリプ
Filípek	フィリーペク
Fišar	フィシャル
Fišer	フィシェル
Fišera	フィシェラ
Flachs	フラフス
Flek	フレク
Flídr	フリードル
Florián	フロリアーン
Florian	フロリアン
Fojt	フォイト
Fojtík	フォイチーク
Fojtů	フォイトゥー
Folta	フォルタ
Foltýn	フォルティーン
Formánek	フォルマーネク
Fořt	フォジュト
Fousek	フォウセク
Franek	フラネク
Franěk	フラニェク
Franta	フランタ
Frič	フリチュ
Fric	フリツ
Frolík	フロリーク
Froněk	フロニェク
Fryč	フリチュ
Frýdl	フリードル
Frydrych	フリドリフ
Fučík	フチーク
Fulín	フリーン
Fusek	フセク
Gábor	ガーボル
Gajda	ガイダ
Gajdoš	ガイドシュ
Gajdošík	ガイドシーク
Gál	ガール
Gašpar	ガシュパル
Gazdík	ガズディーク
Gaži	ガジ
Gregor	グレゴル
Grepl	グレプル
Grošek	グロシェク
Hadač	ハダチュ
Hadrava	ハドラヴァ
Hájek	ハーイエク
Hajný	ハイニー
Hák	ハーク
Hakl	ハクル
Hála	ハーラ
Halama	ハラマ
Halík	ハリーク
Halíř	ハリーシュ
Halouzka	ハロウスカ
Haluška	ハルシュカ
Haluza	ハルザ
Hamáček	ハマーチェク
Hamerník	ハメルニーク
Hána	ハーナ
Hanáček	ハナーチェク
Hanák	ハナーク
Handl	ハンドル
Hanko	ハンコ
Hanousek	ハノウセク
Hanus	ハヌス
Hanuš	ハヌシュ
Hanzelka	ハンゼルカ
Hanzlíček	ハンズリーチェク
Hanzlík	ハンズリーク
Hartl	ハルトル
Hašek	ハシェク
Havel	ハヴェル
Havelka	ハヴェルカ
Havlíček	ハヴリーチェク
Havlík	ハヴリーク
Havlín	ハヴリーン
Havran	ハヴラン
Havránek	ハヴラーネク
Havrda	ハヴルダ
Hečko	ヘチュコ
Hejda	ヘイダ
Hejduk	ヘイドゥク、ヘイドゥック
Hejl	ヘイル
Hejna	ヘイナ
Hejný	ヘイニー
Hejtmánek	ヘイトマーネク
Helešic	ヘレシツ
Heller	ヘッレル
Hendrych	ヘンドリフ
Henzl	ヘンズル
Herák	ヘラーク
Hercík	ヘルツィーク
Heřman	ヘジュマン
Heřmánek	ヘジュマーネク
Herzán	ヘルザーン
Hladík	ハラディーク
Hladký	ハラトキー
Hlava	ハラヴァ
Hlaváč	ハラヴァーチュ
Hlavač	ハラヴァチュ
Hlaváček	ハラヴァーチェク
Hlavaček	ハラヴァチェク
Hlavatý	ハラヴァティー
Hlavica	ハラヴィツァ
Hlavička	ハラヴィチュカ
Hlavinka	ハラヴィンカ
Hlávka	ハラーフカ
Hlavnička	ハラヴニチュカ
Hlavsa	ハラフサ
Hlinka	ハリンカ
Hloušek	ハロウシェク
Hložek	ハロジェク
Hlubuček	ハルブチェク
Hnát	ハナート
Hnátek	ハナーテク
Hnilička	ハニリチュカ
Hnízdil	ハニーズディル
Hodek	ホデク
Hofírek	ホフィーレク
Holásek	ホラーセク
Holčák	ホルチャーク
Holec	ホレツ
Holeček	ホレチェク
Holek	ホレク
Holeš	ホレシュ
Holický	ホリツキー
Holík	ホリーク
Holinka	ホリンカ
Holiš	ホリシュ
Holomek	ホロメク
Holoubek	ホロウベク
Holub	ホルプ
Holubec	ホルベツ
Holuša	ホルシャ
Holý	ホリー
Honzík	ホンズィーク
Horaček	ホラチェク
Horáček	ホラーチェク
Horák	ホラーク
Hořák	ホジャーク
Horálek	ホラーレク
Horčička	ホルチチュカ
Hořejší	ホジェイシー
Hořínek	ホジーネク
Horký	ホルキー
Horňák	ホルニャーク
Horníček	ホルニーチェク
Horník	ホルニーク
Horský	ホルスキー
Horvát	ホルヴァート
Horyna	ホリナ
Hošek	ホシェク
Hotárek	ホターレク
Hotový	ホトヴィー
Houdek	ホウデク
Houska	ホウスカ
Houška	ホウシュカ
Houžvička	ホウジュヴィチュカ
Hovorka	ホヴォルカ
Hozák	ホザーク
Hrabák	ハラバーク
Hrabal	ハラバル
Hrabánek	ハラバーネク
Hrabě	ハラビェ
Hrabec	ハラベツ
Hrabovský	ハラボフスキー
Hrachovec	ハラホヴェツ
Hradecký	ハラデツキー
Hrádek	ハラーデク
Hradil	ハラディル
Hradský	ハラツキー
Hrazdil	ハラズディル
Hrbáč	ハルバーチュ
Hrbáček	ハルバーチェク
Hrbek	ハルベク
Hrdina	ハルディナ
Hrdlička	ハルドリチュカ
Hrdý	ハルディー
Hřebíček	ハジェビーチェク
Hrnčíř	ハルンチーシュ
Hroch	ハロフ
Hromada	ハロマダ
Hromádka	ハロマートカ
Hromek	ハロメク
Hron	ハロン
Hronek	ハロネク
Hrouda	ハロウダ
Hrstka	ハルストカ
Hrubeš	ハルベシュ
Hrubý	ハルビー
Hruška	ハルシュカ
Hrůza	ハルーザ
Hubáček	フバーチェク
Hubálek	フバーレク
Hubený	フベニー
Hubka	フプカ
Hudák	フダーク
Hudec	フデツ
Hudeček	フデチェク
Hůla	フーラ
Hůlka	フールカ
Huml	フムル
Hůrka	フールカ
Hurta	フルタ
Husák	フサーク
Husár	フサール
Hušek	フシェク
Hvězda	ハヴェズダ
Hynek	ヒネク
Hýsek	ヒーセク
Indra	インドラ
Indrák	インドラーク
Jabůrek	ヤブーレク
Jadrný	ヤドルニー
Jagoš	ヤゴシュ
Jahoda	ヤホダ
Jakeš	ヤケシュ
Jakl	ヤクル
Jákl	ヤークル
Jakoubek	ヤコウベク
Jakubec	ヤクベツ
Jakubík	ヤクビーク
Jalůvka	ヤルーフカ
Janáč	ヤナーチュ
Janáček	ヤナーチェク
Janák	ヤナーク
Janata	ヤナタ
Janča	ヤンチャ
Jančík	ヤンチーク
Janda	ヤンダ
Jandaček	ヤンダチェク
Jandík	ヤンディーク
Janeček	ヤネチェク
Janečka	ヤネチュカ
Janek	ヤネク
Janiček	ヤニチェク
Janíček	ヤニーチェク
Janík	ヤニーク
Janiš	ヤニシュ
Jankovič	ヤンコヴィチュ
Jankovský	ヤンコフスキー
Janků	ヤンクー
Janoš	ヤノシュ
Janošek	ヤノシェク
Janošík	ヤノシーク
Janota	ヤノタ
Janouch	ヤノウフ
Janouš	ヤノウシュ
Janoušek	ヤノウシェク
Janovský	ヤノフスキー
Jánský	ヤーンスキー
Janský	ヤンスキー
Janů	ヤヌー
Januš	ヤヌシュ
Jareš	ヤレシュ
Jarkovský	ヤルコフスキー
Jarolím	ヤロリーム
Jarolímek	ヤロリーメク
Jaroš	ヤロシュ
Jarošík	ヤロシーク
Jarý	ヤリー
Jašek	ヤシェク
Javorský	ヤヴォルスキー
Javůrek	ヤヴーレク
Jebavý	イエバヴィー
Jech	イエフ
Jedlička	イエドリチュカ、イェドリチュカ
Jehlička	イエフリチュカ
Jelínek	イエリーネク
Jemelka	イエメルカ
Jeníček	イエニーチェク
Jeník	イエニーク
Jeřábek	イエジャーベク
Jeremiáš	イェレミアーシュ
Jež	イエシュ
Ježek	イエジェク
Jícha	イーハ
Jílek	イーレク
Jindra	インドラ
Jindřich	インドジフ
Jíra	イーラ
Jiráček	イラーチェク
Jirák	イラーク
Jiránek	イラーネク
Jirásek	イラーセク
Jireš	イレシュ
Jiříček	イジーチェク
Jiřička	イジチュカ
Jiřík	イジーク
Jirka	イルカ
Jirkovský	イルコフスキー
Jirků	イルクー
Jirouš	イロウシュ
Jiroušek	イロウシェク
Jirout	イロウト
Jírovec	イーロヴェツ
Jirsa	イルサ
Jíša	イーシャ
Jonák	ヨナーク
Jonáš	ヨナーシュ
Jordán	ヨルダーン
Jukl	ユクル
Junek	ユネク
Juračka	ユラチュカ
Jurák	ユラーク
Juráň	ユラーン
Juránek	ユラーネク
Jurásek	ユラーセク
Jurášek	ユラーシェク
Jurča	ユルチャ
Jurčík	ユルチーク
Jureček	ユレチェク
Jurečka	ユレチュカ
Jurek	ユレク
Juřena	ユジェナ
Juřica	ユジツァ
Juříček	ユジーチェク
Juřička	ユジチュカ
Juřík	ユジーク
Jurka	ユルカ
Jůza	ユーザ
Kabát	カバート
Kabeláč	カベラーチュ
Kabelka	カベルカ
Kábrt	カーブルト
Kačer	カチェル
Kachlík	カフリーク
Kačírek	カチーレク
Kadavý	カダヴィー
Kadeřábek	カデジャーベク
Kadlčákov	カドルチャーコフ
Kadlček	カドルチェク
Kadlčík	カドルチーク
Kadlec	カドレツ
Kadleček	カドレチェク
Kafka	カフカ
Kahánek	カハーネク
Kaláb	カラープ
Kalaš	カラシュ
Kalčík	カルチーク
Kaleja	カレヤ
Kaleta	カレタ
Kalina	カリナ
Kališ	カリシュ
Kalivoda	カリヴォダ
Kalous	カロウス
Kalousek	カロウセク
Kaluža	カルジャ
Kalvoda	カルヴォダ
Kamenický	カメニツキー
Kameník	カメニーク
Kamenský	カメンスキー
Káňa	カーニャ
Kaňa	カニャ
Kaňák	カニャーク
Kaňka	カンカ
Kaňkovský	カンコフスキー
Kaňok	カニョク
Kapoun	カポウン
Karafiát	カラフィアート
Karas	カラス
Karásek	カラーセク
Karel	カレル
Kareš	カレシュ
Karlík	カルリーク
Kárník	カールニーク
Karpíšek	カルピーシェク
Kasal	カサル
Kaše	カシェ
Kašík	カシーク
Kasík	カシーク
Kaška	カシュカ
Kasl	カスル
Kašný	カシュニー
Kašpar	カシュパル
Kašpárek	カシュパーレク
Kaštánek	カシュターネク
Kaucký	カウツキー
Kavka	カフカ
Kazda	カズダ
Kilián	キリアーン
Kincl	キンツル
Klapka	クラプカ
Klásek	クラーセク
Klečka	クレチュカ
Klíč	クリーチュ
Klička	クリチュカ
Klika	クリカ
Klíma	クリーマ
Klimek	クリメク
Klímek	クリーメク
Klimeš	クリメシュ
Klimša	クリムシャ
Klofáč	クロファーチュ
Klouček	クロウチェク
Klouda	クロウダ
Klusáček	クルサーチェク
Klusák	クルサーク
Kment	クメント
Kmoníček	クモニーチェク
Knápek	クナーペク
Knížek	クニージェク
Knotek	クノテク
Kobliha	コブリハ
Koblížek	コブリージェク
Kobylka	コビルカ
Kočí	コチー
Kocián	コツィアーン
Kočka	コチュカ
Kocourek	コツォウレク
Kočvara	コチュヴァラ
Kofroň	コフロン
Kohoutek	コホウテク
Kokeš	コケシュ
Kokoška	ココシュカ
Koky	コキ
Koláček	コラーチェク
Koláčný	コラーチュニー
Kolaja	コラヤ
Kolář	コラーシュ
Kolařík	コラジーク
Kolda	コルダ
Kolek	コレク
Kolínek	コリーネク
Kolínský	コリーンスキー
Kolomazník	コロマズニーク
Komárek	コマーレク
Komenda	コメンダ
Komenský	コメンスキー
Komínek	コミーネク
Komzák	コムザーク
Koňařík	コニャジーク
Konečný	コネチュニー
Koníček	コニーチェク
Konopásek	コノパーセク
Konvalinka	コンヴァリンカ
Konvička	コンヴィチュカ
Konvičný	コンヴィチュニー
Kopáček	コパーチェク
Kopačka	コパチュカ
Kopal	コパル
Kopeček	コペチェク
Kopecký	コペツキー
Kopečný	コペチュニー
Kopřiva	コプシヴァ
Kořán	コジャーン
Koranda	コランダ
Korčák	コルチャーク
Kordík	コルディーク
Korec	コレツ
Korecký	コレツキー
Kořenek	コジェネク
Kořínek	コジーネク
Kos	コス
Košař	コシャシュ
Kosař	コサシュ
Košek	コシェク
Kosek	コセク
Kosík	コシーク
Kosina	コシナ
Košťál	コシュチャール
Kostelecký	コステレツキー
Kostelník	コステルニーク
Kostka	コストカ
Kotas	コタス
Kotásek	コターセク
Kotek	コテク
Kotík	コチーク
Kotlár	コトラール
Kotrba	コトルバ
Kotrč	コトルチュ
Kouba	コウバ
Koubek	コウベク
Koucký	コウツキー
Koudela	コウデラ
Koudelka	コウデルカ
Koukal	コウカル
Kouřil	コウジル
Koutník	コウトニーク
Koutný	コウトニー
Koutský	コウツキー
Kováč	コヴァーチュ
Kováčik	コヴァーチク
Koval	コヴァル
Kovalčík	コヴァルチーク
Kovanda	コヴァンダ
Kovář	コヴァーシュ
Kovářík	コヴァージーク
Kovařík	コヴァジーク
Kozák	コザーク
Kozel	コゼル
Koželuh	コジェルフ
Kožený	コジェニー
Kožíšek	コジーシェク
Kozlík	コズリーク
Kozubík	コズビーク
Kožušník	コズシュニーク
Kracík	クラツィーク
Kráčmar	クラーチュマル
Krahulec	クラフレツ
Krajča	クライチャ
Krajčovič	クライチョヴィチュ
Krajíček	クライーチェク
Krákora	クラーコラ
Král	クラール
Králíček	クラーリーチェク
Králík	クラーリーク
Kramář	クラマーシュ
Krása	クラーサ
Krásný	クラースニー
Krátký	クラートキー
Kratochvíl	クラトフヴィール
Kratochvil	クラトフヴィル
Krbec	クルベツ
Krč	クルチュ
Krčál	クルチャール
Krček	クルチェク
Krčma	クルチュマ
Krčmář	クルチュマーシュ
Křeček	クシェチェク
Krejča	クレイチャ
Krejcar	クレイツァル
Krejčí	クレイチー
Krejčík	クレイチーク
Krejčíř	クレイチーシュ
Krejčiřík	クレイチジーク
Krejsa	クレイサ
Krejza	クレイザ
Křen	クシェン
Křenek	クシェネク
Křepelka	クシェペルカ
Křesťan	クシェスチャン
Křička	クシチュカ
Křikava	クシカヴァ
Krist	クリスト
Křístek	クシーステク
Kristek	クリステク
Krištof	クリシュトフ
Křivan	クシヴァン
Křivánek	クシヴァーネク
Křivka	クシフカ
Křivský	クシフスキー
Kříž	クシーシュ
Križ	クリシュ
Křížek	クシージェク
Krkoška	クルコシュカ
Krobot	クロボト
Kročil	クロチル
Kropáč	クロパーチュ
Kropáček	クロパーチェク
Kroščen	クロシュチェン
Kroupa	クロウパ
Kroutil	クロウチル
Krpálek	クルパーレク
Krpec	クルペツ
Krsek	クルセク
Krška	クルシュカ
Kruliš	クルリシュ
Krupa	クルパ
Krupička	クルピチュカ
Krupka	クルプカ
Krušina	クルシナ
Krůta	クルータ
Kružík	クルジーク
Kryštof	クリシュトフ
Kubala	クバラ
Kubálek	クバーレク
Kubáň	クバーン
Kubánek	クバーネク
Kubásek	クバーセク
Kubát	クバート
Kubec	クベツ
Kubeček	クベチェク
Kubečka	クベチュカ
Kubelík	クベリーク
Kubelka	クベルカ
Kuběna	クビェナ
Kubeš	クベシュ
Kubica	クビツァ
Kubíček	クビーチェク
Kubík	クビーク
Kubín	クビーン
Kubiš	クビシュ
Kubišta	クビシュタ
Kubů	クブー
Kuča	クチャ
Kučera	クチェラ
Kuchař	クハシュ
Kuchařík	クハジーク
Kuchta	クフタ
Kučírek	クチーレク
Kudela	クデラ
Kudělka	クジェルカ
Kudláček	クドラーチェク
Kudlička	クドリチュカ
Kudrna	クドルナ
Kufa	クファ
Kukačka	クカチュカ
Kukla	ククラ
Kuklík	ククリーク
Kulhánek	クルハーネク
Kulhavý	クルハヴィー
Kulich	クリフ
Kulík	クリーク
Kulíšek	クリーシェク
Kuna	クナ
Kundrát	クンドラート
Kuneš	クネシュ
Kupčík	クプチーク
Kupec	クペツ
Kupka	クプカ
Kurečka	クレチュカ
Kůrka	クールカ
Kurka	クルカ
Kůs	クース
Kusák	クサーク
Kusý	クスィー
Kutil	クチル
Kutílek	クチーレク
Kužel	クジェル
Kužela	クジェラ
Kvapil	クヴァピル
Kvasnička	クヴァスニチュカ
Květoň	クヴェトン
Kyncl	キンツル
Kysela	キセラ
Kyselý	キセリー
Lakatoš	ラカトシュ
Lakomý	ラコミー
Lamač	ラマチュ
Landa	ランダ
Langr	ラングル
Láník	ラーニーク
Lánský	ラーンスキー
Lapčík	ラプチーク
Lasák	ラサーク
Láska	ラースカ
Laštovička	ラシュトヴィチュカ
Laštovka	ラシュトフカ
Laštůvka	ラシュトゥーフカ
Látal	ラータル
Lavička	ラヴィチュカ
Lazar	ラザル
Láznička	ラーズニチュカ
Lebeda	レベダ
Ledvina	レドヴィナ
Ledvinka	レドヴィンカ
Lehký	レフキー
Lejsek	レイセク
Lekeš	レケシュ
Lelek	レレク
Lepka	レプカ
Lesák	レサーク
Levý	レヴィー
Lhoták	ルホターク
Lhotský	ルホツキー
Líbal	リーバル
Lindovský	リンドフスキー
Linek	リネク
Lipka	リプカ
Lipovský	リポフスキー
Lipský	リプスキー
Lipták	リプターク
Liška	リシュカ
Lisý	リスィー
Lněnička	ルニェニチュカ
Lošťák	ロシュチャーク
Loučka	ロウチュカ
Louda	ロウダ
Loukota	ロウコタ
Ludvík	ルドヴィーク
Lukáč	ルカーチュ
Lukáš	ルカーシュ
Lukášek	ルカーシェク
Lukeš	ルケシュ
Luňáček	ルニャーチェク
Luňák	ルニャーク
Lupač	ルパチュ
Lyčka	リチュカ
Lysák	リサーク
Máca	マーツァ
Macák	マツァーク
Mácal	マーツァル
Maceček	マツェチェク
Macek	マツェク
Mach	マフ
Mácha	マーハ
Macháč	マハーチュ
Machač	マハチュ
Macháček	マハーチェク
Machala	マハラ
Machálek	マハーレク
Machek	マヘク
Machovec	マホヴェツ
Machů	マフー
Macík	マツィーク
Macků	マツクー
Maděra	マジェラ
Mádr	マードル
Mahdal	マフダル
Makovec	マコヴェツ
Makovička	マコヴィチュカ
Makovský	マコフスキー
Makula	マクラ
Malát	マラート
Malec	マレツ
Maleček	マレチェク
Málek	マーレク
Malík	マリーク
Mališ	マリシュ
Malý	マリー
Maňák	マニャーク
Maňásek	マニャーセク
Mandík	マンディーク
Mandlík	マンドリーク
Mánek	マーネク
Mára	マーラ
Mareček	マレチェク
Marek	マレク
Mareš	マレシュ
Mařík	マジーク
Markovič	マルコヴィチュ
Maroušek	マロウシェク
Maršálek	マルシャーレク
Maršík	マルシーク
Martinák	マルチナーク
Martinec	マルチネツ
Martinek	マルチネク
Martínek	マルチーネク
Martiník	マルチニーク
Martinovský	マルチノフスキー
Martinů	マルチヌー
Martynek	マルティネク
Maryška	マリシュカ
Máša	マーシャ
Masařík	マサジーク
Mašek	マシェク
Mašín	マシーン
Maška	マシュカ
Masopust	マソプスト
Maštalíř	マシュタリーシュ
Mastný	マストニー
Matěj	マチェイ
Matějček	マチェイチェク
Matějíček	マチェイーチェク
Matějka	マチェイカ
Matějovský	マチェヨフスキー
Matějů	マチェユー
Mátl	マートル
Matouš	マトウシュ
Matoušek	マトウシェク
Matula	マトゥラ
Matura	マトゥラ
Matušek	マトゥシェク
Matuška	マトゥシュカ
Matyáš	マティアーシュ
Matys	マティス
Matýsek	マティーセク
Mazáč	マザーチュ
Mazal	マザル
Mazanec	マザネツ
Mazánek	マザーネク
Mazur	マズル
Měchura	メフラ
Medek	メデク
Meduna	メドゥナ
Mejzlík	メイズリーク
Melichar	メリハル
Melka	メルカ
Mencl	メンツル
Menšík	メンシーク
Měrka	メルカ
Merta	メルタ
Mertl	メルトル
Metelka	メテルカ
Míča	ミーチャ
Míček	ミーチェク
Michal	ミハル
Míchal	ミーハル
Michalčík	ミハルチーク
Michalec	ミハレツ
Michálek	ミハーレク
Michalík	ミハリーク
Michl	ミフル
Michna	ミフナ
Mička	ミチュカ
Mika	ミカ
Míka	ミーカ
Mikel	ミケル
Mikeš	ミケシュ
Mikeska	ミケスカ
Miklík	ミクリーク
Miko	ミコ
Mikoláš	ミコラーシュ
Mikolášek	ミコラーシェク
Mikšík	ミクシーク
Mikšovský	ミクショフスキー
Mikula	ミクラ
Mikuláš	ミクラーシュ
Mikulášek	ミクラーシェク
Mikulec	ミクレツ
Mikulecký	ミクレツキー
Mikulenka	ミクレンカ
Mikulík	ミクリーク
Mikulka	ミクルカ
Mikuš	ミクシュ
Milota	ミロタ
Minář	ミナーシュ
Minarčík	ミナルチーク
Minařík	ミナジーク
Míšek	ミーシェク
Miškovský	ミシュコフスキー
Mitáš	ミターシュ
Mizera	ミゼラ
Mládek	ムラーデク
Mlčák	ムルチャーク
Mlejnek	ムレイネク
Mlynář	ムリナーシュ
Mlýnek	ムリーネク
Mohyla	モヒラ
Mojžíš	モイジーシュ
Mokroš	モクロシュ
Mokrý	モクリー
Molnár	モルナール
Moravčík	モラフチーク
Moravec	モラヴェツ
Morávek	モラーヴェク
Motyčka	モティチュカ
Moučka	モウチュカ
Moudrý	モウドリー
Mráček	ムラーチェク
Mraček	ムラチェク
Mráz	ムラース
Mrázek	ムラーゼク
Mrkva	ムルクヴァ
Mrkvička	ムルクヴィチュカ
Mucha	ムハ
Mudra	ムドラ
Munzar	ムンザル
Musil	ムシル
Musílek	ムシーレク
Muška	ムシュカ
Mužík	ムジーク
Mynář	ミナーシュ
Myšák	ミシャーク
Myška	ミシュカ
Myslivec	ミスリヴェツ
Mysliveček	ミスリヴェチェク
Nádvorník	ナードヴォルニーク
Nakládal	ナクラーダル
Nápravník	ナープラヴニーク
Návrat	ナーヴラト
Navrátil	ナヴラーチル
Nebeský	ネベスキー
Nečas	ネチャス
Nechanický	ネハニツキー
Nechvátal	ネフヴァータル
Nedbal	ネドバル
Neděla	ネジェラ
Nedoma	ネドマ
Nedvěd	ネドヴェト
Nekola	ネコラ
Němec	ニェメツ
Němeček	ニェメチェク
Nepraš	ネプラシュ
Nerad	ネラト
Nešpor	ネシュポル
Nesvadba	ネスヴァドバ
Netík	ネチーク
Netolický	ネトリツキー
Netušil	ネトゥシル
Neužil	ネウジル
Nezbeda	ネズベダ
Nezval	ネズヴァル
Nikl	ニクル
Nohejl	ノヘイル
Nosek	ノセク
Nováček	ノヴァーチェク
Novaček	ノヴァチェク
Novák	ノヴァーク
Novosád	ノヴォサート
Novotný	ノヴォトニー
Nový	ノヴィー
Nožička	ノジチュカ
Nykl	ニクル
Nývlt	ニーヴルト
Obdržálek	オブドルジャーレク
Obrovský	オブロフスキー
Očenášek	オチェナーシェク
Odložil	オドロジル
Odstrčil	オツトルチル
Odvárka	オドヴァールカ
Oláh	オラーフ
Olejník	オレイニーク
Olšák	オルシャーク
Onderka	オンデルカ
Ondra	オンドラ
Ondráček	オンドラーチェク
Ondrák	オンドラーク
Ondrášek	オンドラーシェク
Ondříček	オンドジーチェク
Ondroušek	オンドロウシェク
Ondruch	オンドルフ
Ondruš	オンドルシュ
Opatrný	オパトルニー
Opletal	オプレタル
Opluštil	オプルシュチル
Opočenský	オポチェンスキー
Oravec	オラヴェツ
Orel	オレル
Orság	オルサーク
Osička	オシチュカ
Ošťádal	オシュチャーダル
Ostrčil	オストルチル
Otáhal	オターハル
Pacák	パツァーク
Pačes	パチェス
Pagáč	パガーチュ
Pajer	パイエル
Palacký	パラツキー
Palán	パラーン
Palát	パラート
Paleček	パレチェク
Páleníček	パーレニーチェク
Páleník	パーレニーク
Palička	パリチュカ
Pálka	パールカ
Panáček	パナーチェク
Pánek	パーネク
Papež	パペシュ
Papoušek	パポウシェク
Páral	パーラル
Pařík	パジーク
Pařízek	パジーゼク
Paroubek	パロウベク
Pašek	パシェク
Paseka	パセカ
Pastorek	パストレク
Pastrňák	パストルニャーク
Pastyřík	パスティジーク
Paták	パターク
Pátek	パーテク
Patka	パトカ
Patočka	パトチュカ
Paulík	パウリーク
Pávek	パーヴェク
Pavel	パヴェル
Pavelec	パヴェレツ
Pavelek	パヴェレク
Pavelka	パヴェルカ
Pavlas	パヴラス
Pavlásek	パヴラーセク
Pavlát	パヴラート
Pavlica	パヴリツァ
Pavlíček	パヴリーチェク
Pavlík	パヴリーク
Pavliš	パヴリシュ
Pavlovič	パヴロヴィチュ
Pavlovský	パヴロフスキー
Pavlů	パヴルー
Pazderka	パズデルカ
Pazourek	パゾウレク
Pažout	パジョウト
Pečenka	ペチェンカ
Pecha	ペハ
Pecháček	ペハーチェク
Pecina	ペツィナ
Pečinka	ペチンカ
Pecka	ペツカ
Pejša	ペイシャ
Pekař	ペカシュ
Pekárek	ペカーレク
Pěkný	ピェクニー
Pelán	ペラーン
Pelc	ペルツ
Pelikán	ペリカーン
Pelíšek	ペリーシェク
Peňáz	ペニャース
Pěnička	ピェニチュカ
Pěnkava	ピェンカヴァ
Peřina	ペジナ
Pernica	ペルニツァ
Peroutka	ペロウトカ
Pešák	ペシャーク
Pešek	ペシェク
Peška	ペシュカ
Pešl	ペシュル
Pešta	ペシュタ
Peták	ペターク
Petera	ペテラ
Peterek	ペテレク
Peterka	ペテルカ
Petr	ペトル
Petráček	ペトラーチェク
Petrák	ペトラーク
Petráň	ペトラーン
Petráš	ペトラーシュ
Petrásek	ペトラーセク
Petrášek	ペトラーシェク
Petřek	ペッチェク
Petříček	ペッチーチェク
Petřík	ペッチーク
Petrlík	ペトルリーク
Petrů	ペトルー
Petržela	ペトルジェラ
Petrželka	ペトルジェルカ
Picek	ピツェク
Pícha	ピーハ
Pilař	ピラシュ
Pilát	ピラート
Pilný	ピルニー
Pinkas	ピンカス
Pinkava	ピンカヴァ
Piňos	ピニョス
Pírek	ピーレク
Píša	ピーシャ
Piskač	ピスカチュ
Pišna	ピシュナ
Pištěk	ピシュチェク
Piták	ピターク
Pivoňka	ピヴォンカ
Plaček	プラチェク
Plachý	プラヒー
Plánička	プラーニチュカ
Plášek	プラーシェク
Plašil	プラシル
Plášil	プラーシル
Plch	プルフ
Plecháč	プレハーチュ
Plechatý	プレハティー
Plecitý	プレツィティー
Pleskač	プレスカチュ
Plesník	プレスニーク
Pleva	プレヴァ
Plíhal	プリーハル
Plíšek	プリーシェク
Plíva	プリーヴァ
Plšek	プルシェク
Pluhař	プルハシュ
Plzák	プルザーク
Poborský	ポボルスキー
Pochylý	ポヒリー
Podaný	ポダニー
Podešva	ポデシュヴァ
Podhorský	ポドホルスキー
Podroužek	ポドロウジェク
Podzimek	ポドズィメク
Pohanka	ポハンカ
Pohl	ポフル
Pokorný	ポコルニー
Poláček	ポラーチェク
Polách	ポラーフ
Polák	ポラーク
Polanský	ポランスキー
Polášek	ポラーシェク
Poledník	ポレドニーク
Polínek	ポリーネク
Polívka	ポリーフカ
Pololáník	ポロラーニーク
Pompa	ポンパ
Popek	ポペク
Popelka	ポペルカ
Popovič	ポポヴィチュ
Pořízka	ポジースカ
Poslušný	ポスルシュニー
Pospíchal	ポスピーハル
Pospíšil	ポスピーシル
Poštulka	ポシュトゥルカ
Potůček	ポトゥーチェク
Pouzar	ポウザル
Povolný	ポヴォルニー
Prachař	プラハシュ
Prášek	プラーシェク
Prášil	プラーシル
Pražák	プラジャーク
Pražan	プラジャン
Prchlík	プルフリーク
Přecechtěl	プシェツェフチェル
Přibyl	プシビル
Přichystal	プシヒスタル
Přidal	プシダル
Příhoda	プシーホダ
Přikryl	プシクリル
Princ	プリンツ
Procházka	プロハースカ
Prokeš	プロケシュ
Prokopec	プロコペツ
Prokš	プロクシュ
Prokůpek	プロクーペク
Prošek	プロシェク
Prouza	プロウザ
Provazník	プロヴァズニーク
Průcha	プルーハ
Průša	プルーシャ
Pšenička	プシェニチュカ
Ptáček	プターチェク
Ptáčník	プターチュニーク
Pták	プターク
Pudil	プディル
Půlpán	プールパーン
Punčochář	プンチョハーシュ
Pustějovský	プスチェヨフスキー
Pustka	プストカ
Pýcha	ピーハ
Rác	ラーツ
Racek	ラツェク
Ráček	ラーチェク
Rak	ラク
Rambousek	ランボウセク
Raška	ラシュカ
Raszka	ラッスカ
Rataj	ラタイ
Rathouský	ラドホウスキー
Řeháček	ジェハーチェク
Řehák	ジェハーク
Řehoř	ジェホシュ
Rejcha	レイハ
Rejsek	レイセク
Rejzek	レイゼク
Remeš	レメシュ
Řepa	ジェパ
Řepka	ジェプカ
Řeřicha	ジェジハ
Řežábek	ジェジャーベク
Řezáč	ジェザーチュ
Rezek	レゼク
Řezníček	ジェズニーチェク
Řezník	ジェズニーク
Režný	レジュニー
Řídký	ジートキー
Říha	ジーハ
Řihák	ジハーク
Řípa	ジーパ
Roček	ロチェク
Roháč	ロハーチュ
Roháček	ロハーチェク
Rohlík	ロフリーク
Rokos	ロコス
Rosecký	ロセツキー
Roubal	ロウバル
Roubíček	ロウビーチェク
Roučka	ロウチュカ
Roušar	ロウシャル
Rousek	ロウセク
Rožnovský	ロジュノフスキー
Rubáš	ルバーシュ
Rubeš	ルベシュ
Ručka	ルチュカ
Rusek	ルセク
Rusňák	ルスニャーク
Růžek	ルージェク
Ružička	ルジチュカ
Růžička	ルージチュカ
Ryba	リバ
Rybák	リバーク
Rybář	リバーシュ
Rybka	リプカ
Rybníček	リブニーチェク
Rychlík	リフリーク
Rychlý	リフリー
Rychtařík	リフタジーク
Rýdl	リードル
Ryšánek	リシャーネク
Ryšavý	リシャヴィー
Ryška	リシュカ
Rytíř	リチーシュ
Rýznar	リーズナル
Šabata	シャバタ
Šabatka	シャバトカ
Sáblík	サーブリーク
Šácha	シャーハ
Šádek	シャーデク
Sadílek	サディーレク
Šafář	シャファーシュ
Šafařík	シャファジーク
Šafránek	シャフラーネク
Salač	サラチュ
Salajka	サライカ
Salák	サラーク
Šálek	シャーレク
Šámal	シャーマル
Samec	サメツ
Samek	サメク
Šanda	シャンダ
Šandera	シャンデラ
Šandor	シャンドル
Šašek	シャシェク
Schejbal	スヘイバル
Schovánek	スホヴァーネク
Ščuka	シュチュカ
Šebek	シェベク
Šebela	シェベラ
Šebesta	シェベスタ
Šebrle	シェブルレ
Šeda	シェダ
Šedivý	シェディヴィー
Sedláček	セドラーチェク
Sedlák	セドラーク
Sedlář	セドラーシュ
Šedý	シェディー
Šefčík	シェフチーク
Šefl	シェフル
Sehnal	セフナル
Sejkora	セイコラ
Šejna	シェイナ
Sekanina	セカニナ
Šembera	シェンベラ
Semerád	セメラート
Semerák	セメラーク
Semrád	セムラート
Šenk	シェンク
Šenkeřík	シェンケジーク
Šenkýř	シェンキーシュ
Šenkyřík	シェンキジーク
Šerák	シェラーク
Šerý	シェリー
Šesták	シェスターク
Ševčík	シェフチーク
Severa	セヴェラ
Šigut	シグト
Šikl	シクル
Sikora	シコラ
Šikula	シクラ
Šilar	シラル
Šilhan	シルハン
Šilhán	シルハーン
Šilhánek	シルハーネク
Šilhavý	シルハヴィー
Šíma	シーマ
Šimáček	シマーチェク
Šimák	シマーク
Šiman	シマン
Šimánek	シマーネク
Šimčík	シムチーク
Šimeček	シメチェク
Šimek	シメク
Šimíček	シミーチェク
Šimík	シミーク
Šimon	シモン
Šimoník	シモニーク
Šimůnek	シムーネク
Šindelář	シンデラーシュ
Šindelka	シンデルカ
Šindler	シンドレル
Šíp	シープ
Šípek	シーペク
Šír	シール
Šírek	シーレク
Široký	シロキー
Sirotek	シロテク
Šiška	シシュカ
Sivák	シヴァーク
Šivák	シヴァーク
Skácel	スカーツェル
Skala	スカラ
Skála	スカーラ
Skalický	スカリツキー
Skalka	スカルカ
Skalník	スカルニーク
Skalský	スカルスキー
Škarda	シュカルダ
Sklář	スクラーシュ
Sklenář	スクレナーシュ
Sklenička	スクレニチュカ
Škoda	シュコダ
Skokan	スコカン
Škop	シュコプ
Skopal	スコパル
Škopek	シュコペク
Skořepa	スコジェパ
Škorpík	シュコルピーク
Skotnica	スコトニツァ
Skoumal	スコウマル
Skoupý	スコウピー
Škrabal	シュクラバル
Skřivan	スクシヴァン
Skřivánek	スクシヴァーネク
Škrobánek	シュクロバーネク
Škuta	シュクタ
Škvor	シュクヴォル
Skýpala	スキーパラ
Slabý	スラビー
Sládeček	スラーデチェク
Sládek	スラーデク
Sladký	スラトキー
Sláma	スラーマ
Slanina	スラニナ
Slánský	スラーンスキー
Slaný	スラニー
Šlapák	シュラパーク
Slavíček	スラヴィーチェク
Slavický	スラヴィツキー
Slavík	スラヴィーク
Šlechta	シュレフタ
Šlégr	シュレーグル
Slepička	スレピチュカ
Slezáček	スレザーチェク
Slezák	スレザーク
Slíva	スリーヴァ
Slivka	スリフカ
Slouka	スロウカ
Slováček	スロヴァーチェク
Slovaček	スロヴァチェク
Slovák	スロヴァーク
Sluka	スルカ
Šmahel	シュマヘル
Šmehlík	シュメフリーク
Šmejkal	シュメイカル
Smejkal	スメイカル
Smékal	スメーカル
Šmerda	シュメルダ
Smetáček	スメターチェク
Smetana	スメタナ
Šmíd	シュミート
Šmída	シュミーダ
Šmídek	シュミーデク
Smíšek	スミーシェク
Smola	スモラ
Smolík	スモリーク
Šmolík	シュモリーク
Smolka	スモルカ
Smrček	スムルチェク
Smrčka	スムルチュカ
Smrž	スムルシュ
Smutný	スムトニー
Šnajdr	シュナイドル
Snášel	スナーシェル
Šnobl	シュノブル
Snopek	スノペク
Sobek	ソベク
Sobota	ソボタ
Sobotka	ソボトカ
Socha	ソハ
Sochůrek	ソフーレク
Sodomka	ソドムカ
Sojka	ソイカ
Sokol	ソコル
Solař	ソラシュ
Šolc	ショルツ
Soldán	ソルダーン
Šonský	ションスキー
Šotola	ショトラ
Souček	ソウチェク
Soukal	ソウカル
Šoukal	ショウカル
Soukup	ソウクプ
Šourek	ショウレク
Soušek	ソウシェク
Špaček	シュパチェク
Spáčil	スパーチル
Špalek	シュパレク
Šperl	シュペルル
Spěvák	スピェヴァーク
Špičák	シュピチャーク
Špička	シュピチュカ
Spilka	スピルカ
Šplíchal	シュプリーハル
Spurný	スプルニー
Šrámek	シュラーメク
Srb	スルプ
Srba	スルバ
Srnec	スルネツ
Šrom	シュロム
Srp	スルプ
Šrubař	シュルバシュ
Štancl	シュタンツル
Staněk	スタニェク
Staník	スタニーク
Stárek	スターレク
Starý	スタリー
Stašek	スタシェク
Šťastný	シュチャストニー
Štěch	シュチェフ
Štefan	シュテファン
Štefek	シュテフェク
Štefka	シュテフカ
Štefl	シュテフル
Stehlík	ステフリーク
Stehno	ステフノ
Stejskal	ステイスカル
Steklý	ステクリー
Štěpán	シュチェパーン
Štěpánek	シュチェパーネク
Štěpáník	シュチェパーニーク
Štěpnička	シュチェプニチュカ
Štěrba	シュチェルバ
Štětina	シュチェチナ
Štětka	シュチェトカ
Stibor	スチボル
Stibůrek	スチブーレク
Štika	シュチカ
Štípek	シュチーペク
Štochl	シュトフル
Stodola	ストドラ
Stodůlka	ストドゥールカ
Stojka	ストイカ
Stoklasa	ストクラサ
Stoklásek	ストクラーセク
Štolba	シュトルバ
Štorek	シュトレク
Štourač	シュトウラチュ
Šťovíček	シュツォヴィーチェク
Straka	ストラカ
Strakoš	ストラコシュ
Stránský	ストラーンスキー
Stratil	ストラチル
Středa	スッチェダ
Strejc	ストレイツ
Strejček	ストレイチェク
Střelec	スッチェレツ
Stříbrný	スッチーブルニー
Stříteský	スッチーテスキー
Stříž	スッチーシュ
Strmiska	ストルミスカ
Strnad	ストルナト
Strnadel	ストルナデル
Štrobl	シュトロブル
Strouhal	ストロウハル
Štrunc	シュトルンツ
Strýček	ストリーチェク
Stuchlík	ストゥフリーク
Stuchlý	ストゥフリー
Studený	ストゥデニー
Studnička	ストゥドニチュカ
Stupka	ストゥプカ
Šturma	シュトゥルマ
Štursa	シュトゥルサ
Stýblo	スティーブロ
Šuba	シュバ
Šubert	シュベルト
Šubrt	シュブルト
Suchánek	スハーネク
Sucharda	スハルダ
Suchý	スヒー
Suk	スク
Šula	シュラ
Šulák	シュラーク
Šulc	シュルツ
Surý	スリー
Šustek	シュステク
Sůva	スーヴァ
Šváb	シュヴァープ
Svačina	スヴァチナ
Švadlenka	シュヴァドレンカ
Švancara	シュヴァンツァラ
Švanda	シュヴァンダ
Švarc	シュヴァルツ
Svárovský	スヴァーロフスキー
Svatoň	スヴァトン
Svatoš	スヴァトシュ
Švec	シュヴェツ
Švéda	シュヴェーダ
Švehla	シュヴェフラ
Švejda	シュヴェイダ
Svěrák	スヴェラーク
Švestka	シュヴェストカ
Světlík	スヴェトリーク
Sviták	スヴィターク
Svítil	スヴィーチル
Svoboda	スヴォボダ
Švorc	シュヴォルツ
Svozil	スヴォズィル
Švrček	シュヴルチェク
Sychra	スィフラ
Sýkora	スィーコラ
Synek	スィネク
Syrovátka	スィロヴァートカ
Syrový	スィロヴィー
Sysel	スィセル
Táborský	ターボルスキー
Takáč	タカーチュ
Tancoš	タンツォシュ
Teplý	テプリー
Tesař	テサシュ
Tesárek	テサーレク
Tesařík	テサジーク
Ticháček	チハーチェク
Tichý	チヒー
Tkáč	トカーチュ
Tlapák	トラパーク
Tlustý	トルスティー
Tobiáš	トビアーシュ
Tobola	トボラ
Tokár	トカール
Tolar	トラル
Toman	トマン
Tomanec	トマネツ
Tománek	トマーネク
Tomáš	トマーシュ
Tomášek	トマーシェク
Tomeček	トメチェク
Tomek	トメク
Tomeš	トメシュ
Tomíček	トミーチェク
Tomšík	トムシーク
Tomšů	トムシュー
Topič	トピチュ
Toráč	トラーチュ
Tošovský	トショフスキー
Touš	トウシュ
Toušek	トウシェク
Trávníček	トラーヴニーチェク
Trčka	トルチュカ
Trejbal	トレイバル
Třešňák	チェシュニャーク
Tříska	トリースカ
Trněný	トルニェニー
Trnka	トルンカ
Troják	トロヤーク
Trojan	トロヤン
Trubač	トルバチュ
Truhlář	トルフラーシュ
Tučapský	トゥチャプスキー
Tuček	トゥチェク
Tůma	トゥーマ
Tupý	トゥピー
Tureček	トゥレチェク
Turek	トゥレク
Turnovský	トゥルノフスキー
Turoň	トゥロン
Tvarůžek	トヴァルージェク
Tvrdík	トヴルディーク
Tvrdoň	トヴルドン
Tvrdý	トヴルディー
Tvrzník	トヴルズニーク
Uchytil	ウヒチル
Uhlík	ウフリーク
Uhlíř	ウフリーシュ
Urban	ウルバン
Urbančík	ウルバンチーク
Urbanec	ウルバネツ
Urbánek	ウルバーネク
Urbášek	ウルバーシェク
Vacek	ヴァツェク
Vach	ヴァフ
Vácha	ヴァーハ
Váchal	ヴァーハル
Vacík	ヴァツィーク
Václavek	ヴァーツラヴェク
Václavík	ヴァーツラヴィーク
Vaidiš	ヴァイディシュ
Vajda	ヴァイダ
Vala	ヴァラ
Vála	ヴァーラ
Valach	ヴァラフ
Valášek	ヴァラーシェク
Valčík	ヴァルチーク
Válek	ヴァーレク
Valenta	ヴァレンタ
Valeš	ヴァレシュ
Valíček	ヴァリーチェク
Valík	ヴァリーク
Vališ	ヴァリシュ
Válka	ヴァールカ
Valoušek	ヴァロウシェク
Váňa	ヴァーニャ
Vančura	ヴァンチュラ
Vaněček	ヴァニェチェク
Vaněk	ヴァニェク
Vaníček	ヴァニーチェク
Vaník	ヴァニーク
Vaniš	ヴァニシュ
Vápeník	ヴァーペニーク
Vařeka	ヴァジェカ
Varmuža	ヴァルムジャ
Vašák	ヴァシャーク
Vašek	ヴァシェク
Vašíček	ヴァシーチェク
Vašina	ヴァシナ
Vaško	ヴァシュコ
Vašut	ヴァシュト
Vaverka	ヴァヴェルカ
Vávra	ヴァーヴラ
Vavrečka	ヴァヴレチュカ
Vavřička	ヴァヴジチュカ
Vavřík	ヴァヴジーク
Vavřina	ヴァヴジナ
Vavruša	ヴァヴルシャ
Vavruška	ヴァヴルシュカ
Večeřa	ヴェチェジャ
Večerek	ヴェチェレク
Večerka	ヴェチェルカ
Vedral	ヴェドラル
Vejvoda	ヴェイヴォダ
Veleba	ヴェレバ
Velecký	ヴェレツキー
Velek	ヴェレク
Velička	ヴェリチュカ
Velíšek	ヴェリーシェク
Vencl	ヴェンツル
Vepřek	ヴェプシェク
Vesecký	ヴェセツキー
Veselka	ヴェセルカ
Veselský	ヴェセルスキー
Veselý	ヴェセリー
Větrovec	ヴェトロヴェツ
Větrovský	ヴェトロフスキー
Veverka	ヴェヴェルカ
Vích	ヴィーフ
Vícha	ヴィーハ
Vidlák	ヴィドラーク
Vik	ヴィク
Viktora	ヴィクトラ
Viktorin	ヴィクトリン
Vilím	ヴィリーム
Vilímek	ヴィリーメク
Vinklárek	ヴィンクラーレク
Vinš	ヴィンシュ
Vintr	ヴィントル
Víšek	ヴィーシェク
Vít	ヴィート
Vitásek	ヴィターセク
Vítek	ヴィーテク
Vitouš	ヴィトウシュ
Vítovec	ヴィートヴェツ
Vítů	ヴィートゥー
Vízek	ヴィーゼク
Vízner	ヴィーズネル
Vlach	ヴラフ
Vláčil	ヴラーチル
Vladyka	ヴラディカ
Vlasák	ヴラサーク
Vlášek	ヴラーシェク
Vlček	ヴルチェク
Vlk	ヴルク
Vobořil	ヴォボジル
Voborník	ヴォボルニーク
Vocásek	ヴォツァーセク
Voda	ヴォダ
Vodák	ヴォダーク
Vodička	ヴォディチュカ
Vodrážka	ヴォドラーシュカ
Vojáček	ヴォヤーチェク
Vojkůvka	ヴォイクーフカ
Vojta	ヴォイタ
Vojtěch	ヴォイチェフ
Vojtek	ヴォイテク
Vojtíšek	ヴォイチーシェク
Vokáč	ヴォカーチュ
Vokál	ヴォカール
Vokoun	ヴォコウン
Vokurka	ヴォクルカ
Volák	ヴォラーク
Voldřich	ヴォルドジフ
Volejník	ヴォレイニーク
Volek	ヴォレク
Volný	ヴォルニー
Vomáčka	ヴォマーチュカ
Vondra	ヴォンドラ
Vondráček	ヴォンドラーチェク
Vondrák	ヴォンドラーク
Vondrášek	ヴォンドラーシェク
Vondrouš	ヴォンドロウシュ
Vondruška	ヴォンドルシュカ
Vopat	ヴォパト
Voráč	ヴォラーチュ
Voráček	ヴォラーチェク
Vorel	ヴォレル
Voříšek	ヴォジーシェク
Vorlíček	ヴォルリーチェク
Vosáhlo	ヴォサーフロ
Vosátka	ヴォサートカ
Vostrý	ヴォストリー
Vosyka	ヴォスィカ
Votava	ヴォタヴァ
Votoček	ヴォトチェク
Votruba	ヴォトルバ
Votýpka	ヴォティープカ
Voženílek	ヴォジェニーレク
Vrabec	ヴラベツ
Vrábel	ヴラーベル
Vráblík	ヴラーブリーク
Vrána	ヴラーナ
Vránek	ヴラーネク
Vranický	ヴラニツキー
Vraný	ヴラニー
Vrátný	ヴラートニー
Vrba	ヴルバ
Vrbický	ヴルビツキー
Vrbka	ヴルプカ
Vršecký	ヴルシェツキー
Vrzal	ヴルザル
Všetečka	フシェテチュカ
Vybíral	ヴィビーラル
Výborný	ヴィーボルニー
Vychodil	ヴィホディル
Vydra	ヴィドラ
Vyhlídal	ヴィフリーダル
Vyhnálek	ヴィフナーレク
Vyhnánek	ヴィフナーネク
Vykoukal	ヴィコウカル
Vykydal	ヴィキダル
Vymazal	ヴィマザル
Vymětal	ヴィメタル
Vyroubal	ヴィロウバル
Vyskočil	ヴィスコチル
Vysloužil	ヴィスロウジル
Vystrčil	ヴィストルチル
Vytlačil	ヴィトラチル
Žabka	ジャプカ
Zabloudil	ザブロウディル
Zábojník	ザーボイニーク
Zábranský	ザーブランスキー
Žáček	ジャーチェク
Zachoval	ザホヴァル
Zadražil	ザドラジル
Zahálka	ザハールカ
Záhora	ザーホラ
Zahrádka	ザフラートカ
Zahradníček	ザフラドニーチェク
Zahradník	ザフラドニーク
Zajac	ザヤツ
Zajíc	ザイーツ
Zajíček	ザイーチェク
Žák	ジャーク
Zálešák	ザーレシャーク
Záleský	ザーレスキー
Žaloudek	ジャロウデク
Žalud	ジャルト
Zamazal	ザマザル
Zámečník	ザーメチュニーク
Žampach	ジャンパフ
Zaoral	ザオラル
Zápotocký	ザーポトツキー
Žárský	ジャールスキー
Záruba	ザールバ
Zástěra	ザースチェラ
Zatloukal	ザトロウカル
Zátopek	ザートペク（ザトペック）
Zavadil	ザヴァディル
Záveský	ザーヴェスキー
Závodný	ザーヴォドニー
Zavřel	ザヴジェル
Zázvorka	ザーズヴォルカ
Zbořil	ズボジル
Zbranek	ズブラネク
Zdeněk	ズデニェク
Zdráhal	ズドラーハル
Zdražil	ズドラジル
Zedek	ゼデク
Zedníček	ゼドニーチェク
Zedník	ゼドニーク
Zelenka	ゼレンカ
Zelený	ゼレニー
Železný	ジェレズニー
Zelinka	ゼリンカ
Zeman	ゼマン
Zemánek	ゼマーネク
Zemek	ゼメク
Žemlička	ジェムリチュカ
Ženatý	ジェナティー
Ženíšek	ジェニーシェク
Zezula	ゼズラ
Zezulka	ゼズルカ
Zich	ズィフ
Židek	ジデク
Žídek	ジーデク
Zídek	ズィーデク
Žiga	ジガ
Zíka	ズィーカ
Zikmund	ズィクムント
Žilka	ジルカ
Zima	ズィマ
Zíma	ズィーマ
Zítek	ズィーテク
Zítka	ズィートカ
Žitník	ジトニーク
Živný	ジヴニー
Žižka	ジシュカ
Zlámal	ズラーマル
Zmeškal	ズメシュカル
Znamenáček	ズナメナーチェク
Zoubek	ゾウベク
Zouhar	ゾウハル
Žůrek	ズーレク
Žurek	ズレク
Zvěřina	ズヴェジナ
Zvolánek	ズヴォラーネク
Zvonek	ズヴォネク
Zvoníček	ズヴォニーチェク
Zýka	ズィーカ