Abel	アーベル
Abele	アーベレ
Abelein	アーベライン
Abendroth	アーベントロート
Abt	アプト
Achatz	アハッツ
Achenbach	アッヘンバッハ
Achenwall	アッヘンヴァル
Achilles	アヒレス
Ackermann	アッカーマン
Acs	アクス
Adalbert	アダルベルト
Adenauer	アデナウアー
Ader	アダー
Adler	アードラー
Adlershelm	アードラースヘルム
Adlung	アードルング
Adorf	アドルフ
Ahle	アーレ
Ahlersmeyer	アーレルスマイアー
Ahrens	アーレンス
Aiblinger	アイブリンガー
Aichberger	アイヒベルガー
Aichhorn	アイヒホルン
Aichinger	アイヒンガー
Albert	アルベルト
Alberth	アルベルト
Albrecht	アルブレヒト
Albrechtsberger	アルブレヒツベルガー
Aldenhoff	アルデンホフ
Alinge	アーリンゲ
Alletsee	アレトゼー
Allhoff	アルホフ
Alpenheim	アルペンハイム
Altdorfer	アルトドルファー
Altenburg	アルテンブルク
Althaus	アルタウス
Altmann	アルトマン
Altmeyer	アルトマイアー
Ambros	アンブロス
Ameln	アメルン
Amend	アーメント
Amerhauser	アメルハウザー
Ande	アンデ
Anders	アンデルス
Androsch	アンドロシュ
Angerer	アンゲラー
Angermann	アンガーマン
Angermüller	アンガーミュラー
Anheisser	アンハイサー
Anker	アンカー
Anschütz	アンシュッツ
Ansorge	アンゾルゲ
Anthes	アンテス
Appel	アッペル
Arendt	アーレント
Arens	アレンス
Armgard	アルムガルト
Armhold	アルムホルト
Armster	アルムスター
Arndt	アルント
Arnim	アルニム
Arnold	アルノルト、アーノルト
Artner	アルトナー
Aschoff	アショフ
Asmus	アスムス
Aspelmayr	アスペルマイヤー
Assmann	アスマン
Auenmüller	アウエンミュラー
Aufrecht	アウフレヒト
Auler	アウラー
Bach	バッハ
Bachem	バッヘム
Bachmann	バッハマン
Bachstein	バッハシュタイン
Bäcker	ベッカー
Backeshof	バッケスホーフ
Backhaus	バックハウス
Bade	バーデ
Bädeker	ベーデカー
Baden	バーデン
Bader	バーダー
Bahlke	バールケ
Bahner	バーナー
Bähr	ベーア
Bahr	バール
Bahre	バーレ
Balling	バルリング
Ballschmiede	バルシュミーデ
Baltzer	バルツァー
Bälz	ベルツ
Balzer	バルツァー
Band	バント
Barbe	バルベ
Barchet	バルヒェット
Barten	バルテン
Barth	バルト
Barthel	バルテル
Bartsch	バルチュ、バーチュ
Basch	バシュ
Basler	バスラー
Batzdorf	バッツドルフ
Bauer	バウアー
Baumann	バウマン
Baumeister	バウマイスター
Baumgart	バウムガルト
Baumgarten	バウムガルテン
Baumgärtner	バウムゲルトナー
Bäumler	ボイムラー
Bayer	バイヤー
Bechtolsheim	ベヒトルスハイム
Beck	ベック
Beckenbauer	ベッケンバウアー
Becker	ベッカー
Beckerath	ベッケラート
Beckmann	ベックマン
Beer	ベーア
Beeth	ベート
Behlendorf	ベーレンドルフ
Behlmer	ベールマー
Behmenburg	ベーメンブルク
Behrend	ベーレント
Behrens	ベーレンス
Beilke	バイルケ
Beilschmidt	バイルシュミット
Beinl	バインル
Beinlich	バインリヒ
Beirer	バイラー
Bellmer	ベルメール、ベルマー
Bender	ベンダー
Benecken	ベネケン
Bengen	ベンゲン
Benken	ベンケン
Benker	ベンカー
Berend	ベレント
Berg	ベルク
Bergau	ベルガウ
Bergemann	ベルゲマン
Bergen	ベルゲン
Bergengrün	ベルゲングリューン
Berger	ベルガー
Bergmann	ベルクマン
Bergmeister	ベアクマイスター
Bergwein	ベルクヴァイン
Berkel	ベアケル
Berkmann	ベルクマン
Berlichingen	ベルリヒンゲン
Bermbach	ベルムバッハ
Bernbacher	ベルンバッハー
Bernet	ベルネット
Bernhard	ベルンハルト
Bernstein	ベルンシュタイン
Berthold	ベルトホルト、ベルトルト
Bertram	ベルトラム
Bertz	ベルツ
Berwald	ベルヴァルト
Besch	ベッシュ
Bessel	ベッセル
Bester	ベスター
Bettendorf	ベッテンドルフ
Beyer	バイアー、バイエル
Bieger	ビーガー
Bierhoff	ビアホフ
Biermann	ビーアマン
Bindernagele	ビンダーナーゲル
Bindewald	ビンデバルト
Bindszus	ビンツス
Birckenstock	ビルケンシュトック
Birrenkoven	ビレンコーフェン
Bischoff	ビショフ
Bittenfeld	ビッテンフェルト
Bitterauf	ビッテラウフ
Bittman	ビットマン
Bittner	ビットナー
Bixler	ビクスラー
Blacher	ブラッハー
Bland	ブラント
Blank	ブランク
Blanke	ブランケ
Blankenheim	ブランケンハイム
Blarr	ブラル
Blech	ブレッヒ
Bleibtreu	ブライプトロイ
Bloch	ブロッホ
Blochwitz	ブロホヴィッツ
Blomberg	ブロムベルク
Blon	ブロン
Blossfeldt	ブロスフェルト
Blücher	ブリュヒャー
Bluhm	ブルーム
Blühm	ブリューム
Blüm	ブリューム
Blume	ブルーメ
Blumentahl	ブルーメンタール
Blumenthal	ブルーメンタール
Blumer	ブルマー
Bobzien	ボプツィーン
Bochmann	ボッホマン
Böckle	ベックレ
Bodart	ボダルト
Bode	ボーデ
Bodenschatz	ボーデンシャッツ
Böhe	ベーエ
Bohländer	ボーレンダー
Böhler	ベーラー
Böhlke	ベールケ
Bohlscheid	ボールシャイト
Böhm	ベーム
Bohme	ボーメ
Böhme	ベーメ
Bohringer	ボーリンガー
Bohrmann	ボーアマン、ボールマン
Böll	ベル
Bollmann	ボルマン
Boltzmann	ボルツマン
Bolz	ボルツ
Bonhof	ボンホフ
Bonmann	ボンマン
Bonno	ボンノ
Borchard	ボルヒャルト
Borchert	ボルヒェルト
Bordewich	ボーデヴィヒ
Borel	ボレル
Bork	ボルク
Bornefeld	ボルネフェルト
Bornemann	ボルネマン
Börner	ベルナー
Bornmann	ボルンマン
Börtz	ベルツ
Bösch	ベッシュ
Bose	ボーゼ
Böse	ベーゼ
Bötel	ベーテル
Böttcher	ベッチャー
Böttner	ベットナー
Bovenschen	ボーヴェンシェン
Brahms	ブラームス
Brand	ブラント
Brandenburg	ブランデンブルク
Brandmüller	ブラントミュラー
Brandt	ブラント
Bransch	ブランシュ
Bräuer	ブラウアー
Brauer	ブラウアー
Braunfels	ブラウンフェルス
Braunschweig	ブラウンシュヴァイク
Brecher	ブレヒャー
Brecht	ブレヒト
Brehme	ブレーメ
Breitenbach	ブライテンバッハ
Breitenreiter	ブライテンライター
Breitkreutz	ブライトクロイツ
Breitner	ブライトナー
Brencke	ブレンケ
Brenneis	ブレンナイス
Breternitz	ブレターニッツ
Breuer	ブロイアー
Breul	ブロイル
Briegel	ブリーゲル
Briesemeister	ブリーゼマイスター
Bringmann	ブリングマン
Brinkmann	ブリンクマン
Britze	ブリッツェ
Bröcker	ブレッカー
Brokmeier	ブロックマイアー
Brömme	ブレンメ
Bronsart	ブロンザルト
Brost	ブロスト
Bruch	ブルッホ
Brückel	ブリュッケル
Brückner	ブリュックナー
Bruckner	ブルックナー
Brügel	ブリューゲル
Brühl	ブリュール
Bruhns	ブルーンス
Brüll	ブリュル
Brün	ブリュン
Brunold	ブルノルト
Brunsmeier	ブルンスマイアー
Bücher	ビュヒャー
Buchholz	ブッフホルツ
Buchmayer	ブフマイヤー
Buchner	ブフナー
Büchner	ビュヒナー
Buchwald	ブッフバルト
Buck	ブック
Buckel	ブッケル
Buers	ビュルス
Buff	ブーフ
Bugenhagen	ブーゲンハーゲン
Buhrmester	ブーアメスター
Bülow	ビューロー
Bungert	ブンゲルト
Bünte	ビュンテ
Burckhardt	ブルクハルト
Bürgener	ビュルゲナー
Burgmüller	ブルクミュラー
Burgstaller	ブルクスタラー
Burgwinkel	ブルクヴィンケル
Bürkner	ビュルクナー
Burmeister	ブルマイスター
Burmester	ブルメスター
Bus	ブス
Busch	ブッシュ
Buschbaum	ブッシュバウム
Buschkötter	ブシュケッター
Büskens	ビュシュケンス
Büssel	ビュッセル
Büsser	ビュッサー
Bütow	ビュートウ
Buttgereit	ブットゲライト
Butting	ブッティング
Büttner	ビュットナー
Buttstett	ブットシュテット
Cannabich	カンナビヒ
Capell	カペル
Carrosa	カロッサ
Cassirer	カシラー、カッシラー
Cerha	チェルハ
Christaller	クリスタラー
Classen	クラッセン
Clausewitz	クラウゼヴィッツ
Clewing	クレヴィング
Coesfeld	コースフェルト
Conz	コンツ
Cornelius	コルネリウス
Corrinth	コリント
Cranach	クラナッハ
Cremer	クレマー
Crüger	クリューガー
Cullmann	クルマン
Cunitz	クーニッツ
Dahlgrün	ダールグリュン
Dahlmann	ダールマン
Dahlmeier	ダールマイアー
Daimler	ダイムラー
Dalberg	ダールベルク
Damisch	ダーミッシュ
Dammenhayn	ダンメンハイン
Dammer	ダマー
Dangelmayr	ダンゲルマイヤー
Danner	ダンナー
Danzi	ダンツィ
Däubler	ドイブラー
Daudert	ダウデルト
Daum	ダウム
David	ダーヴィト
Dedekind	デデキント
Dehmel	デーメル
Dehner	デーナー
Deisler	ダイスラー
Delbrück	デルブリュック
Delius	デリウス
Demantius	デマンティウス
Deneke	デーネケ
Dengler	デングラー
Derlien	デルリーン
Desener	デーゼナー
Dessau	デッサウ
Dessel	デッセル
Dett	デット
Dettmer	デットマー
Detzen	デツェン
Deutsch	ドイチュ
Deutschmann	ドイッチュマン
Dichler	ディヒラー
Dickhaut	ディックハウト
Diebold	ディーボルト
Dieckmann	ディークマン
Diegelmann	ディーゲルマン
Diehl	ディール
Diekmeier	ディークマイアー
Diels	ディールス
Diers	ディールス
Diesburg	ディースブルク
Diesel	ディーゼル
Diesing	ディージング
Dieskau	ディースカウ
Diestel	ディーステル
Diesterweg	ディースターヴェーク
Dieterle	ディターレ
Dietrich	ディートリヒ
Dietz	ディーツ
Dietze	ディーツェ
Dietzel	ディーツェル
Dietzgen	ディーツゲン
Dihanich	ディハニヒ
Dilthey	ディルタイ
Dindorf	ディンドルフ
Dinger	ディンガー
Dingfelder	ディングフェルダー
Dinkel	ディンケル
Dippel	ディッペル
Disselhorst	ディッセルホルスト
Distler	ディストラー
Ditjens	ディトイェンス
Dittenberger	ディッテンベルガー
Dittersdorf	ディッタースドルフ
Dittrich	ディットリヒ
Döbereiner	デーベライナー
Dobner	ドプナー
Doles	ドーレス
Döllinger	デリンガー
Doms	ドムス
Donath	ドナート
Donauer	ドナウアー
Dönitz	デーニッツ
Doppelbauer	ドッペルバウアー
Dorn	ドルン
Dörpfeld	デルプフェルト
Dörr	デーア
Dostal	ドスタル
Dräseke	ドレーゼケ
Dreher	ドレーアー
Dremmler	ドレムラー
Drese	ドレーゼ
Dressel	ドレッセル
Dressler	ドレスラー
Drewanz	ドレヴァンツ
Drewes	ドレヴェス
Dreyer	ドライヤー
Dreyfuss	ドライフース
Dücke	デュッケ
Ducke	ドゥッケ
Dücker	デュカー
Dudenhöffer	ドゥーデンヘッファー
Dühring	デューリング
Dülfer	デュルファー
Dümmler	デュムラー
Dunckel	ドゥンケル
Dünnwald	デュンヴァルト
Dürer	デューラー
Düringer	デューリンガー
Durm	ドゥルム、ドゥアム
Dürrler	デュルラー
Duse	ドゥーゼ
Ebbinghaus	エビングハウス
Ebel	エーベル
Eberhardt	エーベルハルト
Eberlin	エーベルリン
Ebers	エーベルス
Eberth	エーベルト
Eberwein	エーベルヴァイン
Eccard	エッカルト
Eck	エック
Eckener	エッケナー
Eckermann	エッカーマン
Eckert	エッケルト
Eckhardt	エクハルト
Eckhart	エックハルト
Eckhof	エックホーフ
Edel	エーデル
Edelmann	エーデルマン
Edelstein	エーデルシュタイン
Eden	エーデン
Ederer	エデラー
Edinger	エディンガー
Effenberg	エッフェンベルク
Effenberger	エッフェンベルガー
Efler	エフラー
Egel	エーゲル
Eggebrecht	エッゲブレヒト
Eggeling	エッゲリング
Eggers	エッガース
Eggert	エッゲルト、エッガルト
Egner	エグナー
Ehle	エーレ
Ehlers	エーラース
Ehrenberg	エーレンベルク
Ehrenfels	エーレンフェルス
Ehrenfest	エーレンフェスト
Ehrenfreund	エーレンフロイント
Ehrenfried	エーレンフリート
Ehrlich	エールリヒ
Eibenschütz	アイベンシュッツ
Eichberg	アイヒベルク
Eichberger	アイヒベルガー
Eichel	アイヒェル
Eichendorff	アイヒェンドルフ
Eichhorn	アイヒホルン
Eichinger	アイヒンガー
Eichler	アイヒラー
Eichmann	アイヒマン
Eichrodt	アイヒロート
Eickhorst	アイクホルスト
Eickstädt	アイクシュテット
Eigel	アイゲル
Eigen	アイゲン
Eigenrauch	アイゲンラウホ
Eigler	アイクラー
Eilenberg	アイレンベルク
Eilts	アイルツ
Eimer	アイマー
Eimert	アイメルト
Einem	アイネム
Einhard	アインハルト
Eisenhut	アイゼンフート
Eisenlauer	アイゼンラウアー
Eisenschmid	アイゼンシュミット
Eisenstadt	アイゼンシュタット
Eisinger	アイジンガー
Eisler	アイスラー
Eisner	アイスナー
Elert	エーレルト
Ellmenreich	エルメンライヒ
Elsheimer	エルスハイマー
Elster	エルスター
Emmerich	エメリヒ
Emmert	エメルト
Encke	エンケ
Ende	エンデ
Enders	エンデルス
Engel	エンゲル
Engelbert	エンゲルベルト
Engelbrecht	エンゲルブレヒト
Engelhardt	エンゲルハルト
Engelmann	エンゲルマン
Engels	エンゲルス
Engler	エングラー
Enzensberger	エンツェンスベルガー
Equiluz	エクヴィルツ
Erb	エルプ
Erben	エルベン
Erbse	エルプセ
Erckens	エルケンス
Erdmann	エルトマン
Erfurt	エアフルト
Erhard	エアハルト
Erlenmeyer	エルレンマイアー
Erman	エルマン
Ermert	エルメルト
Ernest	エルネスト
Ernst	エルンスト
Erpf	エルプ
Ertl	エルトル
Erzberger	エルツベルガー
Eschenbach	エッシェンバッハ
Esmarch	エスマルヒ
Esser	エッサー
Eßleben	エスレーベン
Eucken	オイケン
Eugn	オイゲン
Eulenberg	オイレンベルク
Eulenburg	オイレンブルク
Eulenspiegel	オイレンシュピーゲル
Euler	オイラー
Ewald	エヴァルト、エーヴァルト
Ewerhart	エーヴァーハルト
Exner	エクスナー
Eyb	アイプ
Eybler	アイブラー
Eysler	アイスラー
Faber	ファーバー
Fackler	ファクラー
Fahberg	ファーベルク
Fahner	ファーナー
Fahrenheit	ファーレンハイト
Fahrenhorst	ファーレンホルスト
Falkenberg	ファルケンベルク
Falkenhayn	ファルケンハイン
Fall	ファル
Faller	ファラー
Fasch	ファッシュ
Fassbender	ファスベンダー
Fassbinder	ファスビンダー
Faulhaber	ファウルハーバー
Faulstich	ファウルシュティヒ
Fechner	フェヒナー
Fecht	フェヒト
Fehenberger	フェーエンベルガー
Fehn	フェーン
Fehringer	フェーリンガー
Feiersinger	ファイアージンガー
Feinen	ファイネン
Feinhals	ファインハルス
Felbermayer	フェルバーマイヤー
Feldhoff	フェルトホフ
Fellmer	フェルマー
Felsenstein	フェルゼンシュタイン
Ferch	フェルヒ
Fernbach	フェルンバッハ
Fessel	フェッセル
Fetz	フェッツ
Feuchtwanger	フォイヒトヴァンガー
Feuerbach	フォイエルバッハ、フォイアーバッハ
Feuge	フォイゲ
Feulgen	フォイルゲン
Feurer	フューラー
Fichter	フィヒター
Fideser	フィデッサー
Fiedler	フィードラー
Fiegler	フィーグラー
Fielitz	フィーリッツ
Filbrich	フィルブリヒ
Filtz	フィルツ
Finck	フィンク
Finger	フィンガー
Fink	フィンク
Finke	フィンケ
Fischer	フィッシャー
Fitzenhagen	フィッツェンハーゲン
Flämig	フレーミヒ
Flarke	フラーケ
Fleischer	フライシャー
Fleisher	フライシャー
Flick	フリック
Flieder	フリーダー
Flinzer	フリンツァー
Flöge	フレーゲ
Flohe	フローエ
Flohn	フローン
Flotow	フロトー
Flür	フリューア
Fölser	フェルザー
Forchert	フォルヒャート
Forst	フォルスト
Förstel	フェルステル
Förstemann	フェルステマン
Förster	フェルスター
Forster	フォルスター
Fortner	フォルトナー
Franck	フランク
Franckenstein	フランケンシュタイン
Frank	フランク
Franke	フランケ
Frankenstein	フランケンシュタイン
Frantz	フランツ
Franz	フランツ
Franzen	フランツェン
Frauenlob	フラウエンロープ
Fraunhofer	フラウンホーファー
Frei	フライ
Freiberg	フライベルク
Freienfels	フライエンフェルス
Freier	フライアー
Freiholz	フライホルツ
Freiligrath	フライリヒラート
Freivogel	フライフォーゲル
Frentzen	フレンツェン
Frenzel	フレンツェル
Freudenthal	フロイデンタール
Freund	フロイント
Frey	フライ
Freytag	フライターク
Friedberg	フリートベルク
Friedel	フリーデル
Friedheim	フリートハイム
Friedhofer	フリードホーファー
Friedhoff	フリートホフ
Friedland	フリートラント
Friedrich	フリードリヒ
Friese	フリーゼ
Friesinger	フリージンガー
Frisch	フリッシュ
Fritsch	フリッチュ
Fritsche	フリッチェ
Fritz	フリッツ
Fritzsche	フリッチェ
Fröbe	フレーベ
Fröbel	フレーベル
Froberger	フローベルガー
Fröhlich	フレーリヒ
Froschauer	フロシャウアー
Frühling	フリューリング
Fuchs	フックス
Fügel	フューゲル
Funk	フンク
Funke	フンケ
Fürmann	フュルマン
Fürst	フュルスト
Fürstenberg	フュルステンベルク
Furtwängler	フルトヴェングラー
Fütterer	フュッテラー
Gabriel	ガーブリエル、ガーブリエール
Gäde	ゲーデ
Gagern	ガーゲルン
Gahmlich	ガームリヒ
Gaiger	ガイガー
Gall	ガル
Gambke	ガンプケ
Garber	ガルバー
Garduhn	ガルドゥーン
Gärtner	ゲルトナー
Gast	ガスト
Gauck	ガウク
Gauss	ガウス
Gayler	ゲイラー
Gebel	ゲーベル
Gebhard	ゲープハルト
Gebhardt	ゲプハルト
Gedeck	ゲデック
Geese	ゲーゼ
Geffert	ゲッフェルト
Gegenbauer	ゲーゲンバウアー
Geisler	ガイスラー
Geisse	ガイセ
Geist	ガイスト
Gelbke	ゲルプケ
Gellermann	ゲラーマン
Gelzer	ゲルツァー
Gentner	ゲントナー
Genuit	ゲヌイト
Genzmar	ゲンツマー
Georgii	ゲオルギー
Gerber	ゲルバー
Gerhardt	ゲーアハルト、ゲルハルト
Gericke	ゲリッケ
Gerl	ゲアル
Gerlach	ゲルラッハ
Gerstenbüttel	ゲルステンビュッテル
Gerster	ゲルスター
Gerstner	ゲルストナー
Gesell	ゲゼル
Gesner	ゲスナー
Gielen	ギーレン
Gierster	ギーアスター
Giesbert	ギースベルト
Giesebrecht	ギーゼブレヒト
Gieseking	ギーゼキング
Giesen	ギーゼン
Giessen	ギーセン
Gietzen	ギーツェン
Gilbert	ギルベルト
Gilenssen	ギレンセン
Gilessen	ギレッセン
Gilhofer	ギルホファー
Gilles	ギレス
Gillesberger	ギレスベルガー
Gillmann	ギルマン
Ginster	ギンスター
Gläser	グレーザー
Glatzel	グラッツェル
Glätzner	グレッツナー
Glaz	グラーツ
Gleissner	グライスナー
Gloeden	グレーデン
Gmür	グミュール
Gneisenau	グナイゼナウ
Gneist	グナイスト
Gödel	ゲーデル
Goebbels	ゲッベルス
Goebels	ゲーベルス
Goedicke	ゲディケ
Goerdeler	ゲルデラー
Goethe	ゲーテ
Göhler	ゲーラー
Goldberg	ゴルトベルク
Goldberger	ゴルトベルガー
Goltz	ゴルツ
Golz	ゴルツ
Göpel	ゲーペル
Göpfert	ゲプフェルト
Göring	ゲーリング
Goritz	ゴリッツ
Görtz	ゲルツ
Gosebruch	ゴーゼブルホ
Goslich	ゴスリヒ
Gössling	ゲスリング
Gottschall	ゴッチャル
Götz	ゲッツ
Götzke	ゲツケ
Grabbe	グラッベ
Gräner	グレーナー
Gräßler	グレスラー
Graun	グラウン
Graunke	グラウンケ
Graupner	グラウプナー
Greilich	グライリヒ
Greiner	グライナー
Griebel	グリーベル
Griem	グリーム
Grillparzer	グリルパルツァー
Grimm	グリム
Grindemann	グリンデマン
Grohl	グロール
Grohmann	グローマン
Gröllmann	グレルマン
Grönemeyer	グレネマイアー
Gröning	グレーニング
Gropius	グロピウス
Gröschel	グレッシェル
Großkopf	グロスコップ
Großkreutz	グロースクロイツ
Grossmann	グロスマン
Groth	グロート
Gruber	グルーバー
Grumbach	グルムバッハ
Grümmer	グリュンマー
Grundmann	グルントマン
Grünewald	グリューネヴァルト
Grüneweller	グリューネヴェラー
Grüning	グリューニング
Gubisch	グビッシュ
Güden	ギューデン
Guderian	グデーリアン
Guericke	ゲーリケ
Gugel	グーゲル
Gümmer	ギュンマー
Günter	ギュンター
Günther	ギュンター
Gura	グーラ
Guski	グスキ
Gutenberg	グーテンベルク
Gutheil	グートハイル
Gutstein	グートシュタイン
Gwinner	グヴィナー
Haake	ハーケ
Haas	ハース
Haase	ハーゼ
Haber	ハーバー
Habich	ハービヒ
Häbler	ヘーブラー
Hack	ハック
Hagen	ハーゲン
Hagenbeck	ハーゲンベック
Hagendorf	ハーゲンドルフ
Hägerich	ヘーゲリヒ
Hagmayer	ハグマイヤー
Hainmüller	ハインミュラー
Hake	ハーケ
Haller	ハーラー
Hamann	ハーマン
Hambüchen	ハームビュッヒェン
Hammerschmidt	ハンマーシュミット
Händschke	ヘンチュケ
Hangstein	ハンクシュタイン
Hanisch	ハニッシュ
Hannawald	ハンナヴァルト
Hannes	ハネス
Hans	ハンス
Hänsch	ヘンシュ
Hansen	ハンゼン
Happe	ハッペ
Hardenberg	ハルデンベルク
Häring	ヘリング
Harnisch	ハーニッシュ
Härtel	ヘルテル
Härter	ヘルター
Hartman	ハルトマン
Hartmann	ハルトマン
Hartog	ハールトーク
Hartwig	ハルトヴィヒ
Hartzenbusch	ハルツェンブッシュ
Hartzheim	ハルツハイム
Harzen	ハルツェン
Hasche	ハシェ
Hascher	ハッシャー
Hasenbein	ハーゼンバイン
Hasenclever	ハーゼンクレファー
Haseney	ハーゼナイ
Hass	ハス
Hasse	ハッセ
Hasselbach	ハッセルバッハ
Hassemer	ハセマー
Hasslacher	ハッスラッハー
Häßler	ヘスラー
Hassler	ハスラー
Hastedt	ハシュテット
Hattenberger	ハッテンベルガー
Hauer	ハウアー
Hauff	ハウフ
Haun	ハウン
Haupt	ハウプト
Hauptmann	ハウプトマン
Hausdorff	ハウスドルフ
Haushofer	ハウスホーファー
Hausknecht	ハウスクネヒト
Häusser	ホイサー
Haydn	ハイドン
Hecht	ヘヒト
Hecken	ヘッケン
Hegel	ヘーゲル
Hegerich	ヘーゲリヒ
Heidegger	ハイデガー
Heidelbach	ハイデルバッハ
Heidelberg	ハイデルベルク
Heidemann	ハイデマン
Heidenreich	ハイデンライヒ
Heidfeld	ハイドフェルト
Heidrich	ハイドリヒ
Heiermann	ハイアーマン
Heimendahl	ハイメンダール
Heimsöth	ハイムゼート
Heinemann	ハイネマン
Heinen	ハイネン
Heinichen	ハイニヒェン
Heintze	ハインツェ
Heinze	ハインツェ
Heinzel	ハインツェル
Heinzmann	ハインツマン
Heise	ハイゼ
Heisenberg	ハイゼンベルク
Heitler	ハイトラー
Heitmann	ハイトマン
Heizmann	ハイツマン
Helbig	ヘルビヒ
Held	ヘルト
Heldt	ヘルト
Helfferich	ヘルフェリヒ
Helgen	ヘルゲン
Hellmann	ヘルマン
Hellmesberger	ヘルメスベルガー
Hellmuth	ヘルムート
Helmer	ヘルマー
Helmold	ヘルモルト
Hempel	ヘンペル
Hengen	ヘンゲン
Henkel	ヘンケル
Henlein	ヘンライン
Hennefeld	ヘンネフェルト
Hennig	ヘニッヒ
Henselt	ヘンゼルト
Henssler	ヘンスラー
Hentig	ヘンティヒ
Henze	ヘンツェ
Herder	ヘルダー
Herfurth	ヘルフルト
Hermann	ヘルマン
Hermel	ヘルメル
Herms	ヘルムス
Herrlich	ヘルリヒ
Hertl	ヘルトル
Hertling	ヘルトリング
Hertz	ヘルツ
Hertzberg	ヘルツベルク
Hertzsch	ヘルツシュ
Herzfeld	ヘルツフェルト
Herzog	ヘルツォーク
Herzogenberg	ヘルツォーゲンベルク
Herzsprung	ヘルツシュプルング
Heß	ヘス
Hettner	ヘットナー
Heuberger	ホイベルガー
Heuer	ホイアー
Heuss	ホイス
Heydrich	ハイドリヒ
Heyn	ハイン
Heynckes	ハインケス
Heyse	ハイゼ
Hiemann	ヒーマン
Hildebrand	ヒルデブラント
Hildesheimer	ヒルデスハイマー
Hildmann	ヒルトマン
Hillenbrand	ヒレンブラント
Hiller	ヒラー
Hilpert	ヒルパート
Hiltmann	ヒルトマン
Himmel	ヒンメル
Hindemith	ヒンデミット
Hindenburg	ヒンデンブルク
Hinkel	ヒンケル
Hintermaier	ヒンターマイヤー
Hintermayer	ヒンターマイヤー
Hirsch	ヒルシュ
Hirschberger	ヒルシュベルガー
Hirschbiegel	ヒルシュビーゲル
Hirschfeld	ヒルシュフェルト
Hirth	ヒルト
Hittorf	ヒットルフ
Hitzelburger	ヒッツェルブルガー
Hitzlsperger	ヒッツルスパーガー
Höbarth	ヘーバルト
Höch	ヘッヒ、ヘーヒ
Hoch	ホッホ、ホーホ
Hödicke	ヘーディケ
Hofer	ホーファー
Höfermeyer	ヘーファーマイアー
Höffgen	ヘフゲン
Hoffmann	ホフマン
Hoffmeister	ホフマイスター
Hofhaimer	ホフハイマー
Hofmann	ホフマン
Hofmannsthal	ホフマンスタール
Hofmannswaldau	ホフマンスヴァルダウ
Hofmeister	ホフマイスター
Hofschneider	ホフシュナイダー
Höger	ヘーガー
Hohenlohe	ホーエンローエ
Höhenrieder	ヘーエンリーダー
Hohlrieder	ホールリーダー
Hölderlin	ヘルダーリン
Höll	ヘル
Holland	ホラント
Höller	ヘラー
Hollerbach	ホーレルバッハ
Holliger	ホリガー
Holm	ホルム
Holstein	ホルシュタイン
Holthaus	ホルトハウス
Hölzel	ヘルツェル
Hölzenbein	ヘルツェンバイン
Hölzl	ヘルツル
Holzmann	ホルツマン
Holzwarth	ホルツヴァート
Höness	ヘーネス
Höpken	ヘプケン
Hörner	ヘルナー
Horngacher	ホルンガッハー
Hübenthal	ヒューベンタール
Huber	フーバー
Hubertus	フーベルトゥス
Hübner	ヒューブナー
Hudemann	フーデマン
Hüfner	ヒュフナー
Hügel	ヒューゲル
Hugenberg	フーゲンベルク
Hügler	ヒューグラー
Hühn	ヒューン
Humboldt	フンボルト
Hummel	フンメル
Humpe	フンペ
Humperdinck	フンパーディンク
Hunzelmann	フンツェルマン
Hüttenbrenner	ヒュッテンブレンナー
Hütter	ヒュッター
Illgner	イルクナー
Immel	インメル
Irmscher	イルムシャー
Istel	イステル
Ittenbach	イッテンバッハ
Jadassohn	ヤダスゾーン
Jäger	イェーガー
Jähne	イェーネ
Jahnn	ヤーン
Jancker	ヤンカー
Janenz	ヤネンツ
Jänsch	イェンシュ
Janssen	ヤンセン
Jarnach	ヤルナッハ
Jebram	イェブラム
Jelinek	イェリネク
Jellinek	イェリネク
Jentsch	イェンチュ
Jeremies	イェレミース
Jerusalem	イェルザレム
Jeschke	イェシュケ
Jessel	イェッセル
Jhering	イェーリング
Joachim	ヨアヒム
Job	ヨープ
Jochum	ヨッフム
Jodl	ヨードル
Jöken	イェーケン
Jonas	ヨーナス
Jooß	ヨース
Jordan	ヨルダン
Jörg	イェルク
Jöris	イェーリス
Jorra	ヨラ
Jung	ユング
Jünger	ユンガー
Junker	ユンカー
Junkers	ユンカース
Jürgen	ユルゲン
Jürgens	ユルゲンス
Jüten	ユーテン
Kahler	カーラー
Kähler	ケーラー
Kahn	カーン
Kallenberg	カレンベルク
Kaltz	カルツ
Kamann	カーマン
Kammer	カマー
Kämpfel	ケンプフェル
Kämpfert	ケンプフェルト
Kant	カント
Kapellmann	カペルマン
Karg	カルク
Kasner	カスナー
Käßmann	ケスマン
Kästner	ケストナー
Kaufmann	カウフマン
Kaumanns	カウマンス
Kaun	カウン
Kaunitz	カウニッツ
Keetmann	ケートマン
Kehl	ケール
Keiser	カイザー
Keller	ケラー
Kempe	ケンペ
Kepler	ケプラー
Kerchensteiner	ケルヒェンシュタイナー
Kerll	ケルル
Kerner	ケルナー
Kersten	ケルステン
Kesselring	ケッセルリング
Kessinger	ケッシンガー
Kesten	ケステン
Kesting	ケスティング
Ketteler	ケッテラー
Keyserling	カイザーリング
Kiderlen	キーデルレン
Kienzl	キーンツル
Kiessling	キースリング
Kindermann	キンダーマン
Kinkel	キンケル
Kipp	キップ
Kirchherr	キルヒヘア（キルヒヘル）
Kirchhoff	キルヒホフ
Kirchmann	キルヒマン
Kirchner	キルヒナー
Kirchschlager	キルヒシュラーガー
Kirnberger	キルンベルガー
Kirsch	キルシュ
Kirschnereit	キルシュネライト
Kirsten	キルステン
Kische	キッシェ
Kiske	キスケ
Kistler	キストラー
Klaiber	クライバー
Klanert	クラネルト
Klarwein	クラルヴァイン
Klaußner	クラウスナー
Klebe	クレーベ
Kleemann	クレーマン
Kleff	クレフ
Kleiber	クライバー
Klein	クライン
Kleinbeck	クラインベック
Kleinert	クライネルト
Kleinmichel	クラインミヒェル
Kleinschmidt	クラインシュミット
Klemm	クレム
Klemperer	クレンペラー
Klengel	クレンゲル
Klenk	クレンク
Klewer	クレヴァー
Klimsch	クリムシュ
Klinsmann	クリンスマン
Kluge	クルーゲ
Klughardt	クルーグハルト
Klum	クルム
Kmetsch	クメッチュ
Knab	クナープ
Knapp	クナップ
Knaust	クナウスト
Kneissl	クナイスル
Knies	クニース
Knietsch	クニーチュ
Knobloch	クノープロッホ
Knochenhauer	クノッヘンハウアー
Knorr	クノール
Knüppel	クニュッペル
Koch	コッホ
Kögl	ケーグル
Kohl	コール
Köhler	ケーラー
Kokoschka	ココシュカ
Kolbe	コルベ
Kölliker	ケリカー
Kollo	コロ
Kollwitz	コルヴィッツ
Koltermann	コルターマン
Kölz	ケルツ
Konetzke	コネッツケ
König	ケーニヒ
Königsperger	ケーニヒスペルガー
Köninger	ケーニンガー
Köpke	ケプケ
Köppen	ケッペン
Kostmann	コストマン
Köth	ケート
Kötter	ケッター
Kracht	クラハト
Kraft	クラフト
Krämer	クレーマー
Kratenstein	クラテンシュタイン
Kray	クライ
Kredel	クレーデル
Krehl	クレール
Kreische	クライシェ
Kreisler	クライスラー
Kremers	クレマース
Kremmer	クレンマー
Kretschmann	クレッチュマン
Kreutzer	クロイツァー、クロイツェル
Kreuz	クロイツ
Krieger	クリーガー
Kriesel	クリーゼル
Kröber	クレーバー
Kröckel	クレッケル
Krohwinkel	クローヴィンケル
Kroß	クロス
Krüger	クリューガー
Kruger	クルーガー
Krull	クルル
Kruse	クルゼ
Küchler	キュヒラー
Kücken	キュッケン
Kügeler	キューゲラー
Kühbauer	キューバウアー
Kuhn	クーン
Kühn	キューン
Kuhnau	クーナウ
Kühne	キューネ
Kühnel	キューネル
Kuhnenfels	クーネンフェルス
Kühnert	キューネルト
Kuhr	クーア
Kunkel	クンケル
Künneke	キュンネケ
Kuntz	クンツ
Küntzel	キュンツェル
Kunze	クンツェ
Kunzendorf	クンツェンドルフ
Küper	キューパー
Kupfer	クプファー
Küpker	キュプカー
Kurth	クルト
Kurz	クルツ
Kurzke	クルツケ
Kusch	クッシュ
Kuske	クスケ
Kuss	クス
Kuster	クスター
Kutt	クット
Küttel	キュッテル
Kutzer	クッツァー
Lacher	ラッハー
Lachner	ラハナー
Lambrecht	ラムブレヒト
Lammers	ランマース
Lammertz	ランメルツ
Lampe	ラムペ
Lampertz	ランペルツ
Lamprecht	ランプレヒト
Lancelle	ランセル
Land	ラント
Lang	ラング
Lange	ランゲ
Langenbach	ランゲンバッハ
Langer	ランガー
Langhans	ラングハンス
Langheim	ラングハイム
Langhein	ラングハイン
Längin	レンギン
Langjahr	ラングヤール
Längner	レングナー
Lanner	ランナー
Lanzinger	ランツィンガー
Lätzsch	レッチュ
Lau	ラウ
Lauck	ラウク
Lauenstein	ラウエンシュタイン
Lauhöfer	ラウヘーファー
Lautenbach	ラウテンバッハ
Lauzening	ラウツェニング
Lay	ライ
Lechner	レヒナー
Leckebusch	レッケブッシュ
Lederer	レデラー
Leffler	レッフラー
Legien	レギーン
Legler	レークラー
Lehar	レハール
Lehde	レーデ
Lehmann	レーマン
Lehmbruck	レームブルック
Lehmkuhl	レームクール
Leibniz	ライプニッツ
Leichtentritt	ライヒテントリット
Leimbacher	ライムバッハー
Leinweber	ラインヴェーヴァー
Leipold	ライポルト
Leisegang	ライゼガング
Leisenheimer	ライゼンハイマー
Leiser	ライザー
Leist	ライスト
Leister	ライスター
Leitz	ライツ
Lemke	レムケ
Lemmen	レンメン
Lemper	レンパー
Lenard	レーナルト
Lenbach	レンバッハ
Lendrich	レントリヒ
Lennartz	レンナルツ
Lenz	レンツ
Leonhardt	レオンハルト
Leopold	レオポルト
Lepsius	レプシウス
Lerch	レルヒ
Lerner	レルナー
Lesser	レッサー
Letsche	レッチェ
Letschert	レッチェルト
Letzel	レッツェル
Lewerenz	レーヴェレンツ
Lewin	レヴィン
Lichtenberg	リヒテンベルク
Lichtenberger	リヒテンベルガー
Lichtenstein	リヒテンシュタイン
Lieber	リーバー
Liebermann	リーバーマン
Liebert	リーベルト
Liebig	リービヒ
Liebknecht	リープクネヒト
Liebmann	リープマン
Liedtke	リートケ
Liefmann	リーフマン
Lienert	リーネルト
Liersch	リールシュ
Liesenfeld	リーゼンフェルト
Liessfeldt	リースフェルト
Liessmann	リースマン
Lietz	リーツ
Lietzmann	リーツマン
Liliencron	リリエンクローン
Lilienthal	リリエンタール
Lincke	リンケ
Lindemann	リンデマン
Lindenberg	リンデンベルク
Lindenberger	リンデンベルガー
Lindner	リントナー
Lindpaintner	リンドパイントナー
Linel	リーネル
Linhard	リンハルト
Link	リンク
Linke	リンケ
Linne	リンネ
Lipmann	リップマン
Lippmann	リップマン
Lipps	リップス
Lis	リス
List	リスト
Liszt	リスト
Litt	リット
Litterst	リッテルスト
Löbel	レーベル
Löbmann	レープマン
Löffler	レッフラー
Lohenstein	ローエンシュタイン
Lohmann	ローマン
Lohmeyer	ローマイアー
Löhrmann	レールマン
Lohse	ローゼ
Longen	ロンゲン
Lorbach	ロルバッハ
Lorenz	ローレンツ
Lörke	レールケ
Lörsch	レルシュ
Lortzing	ロルツィング
Losch	ロッシュ
Lothar	ローター
Lottner	ロットナー
Löven	レーヴェン
Löw	レーヴ
Löwe	レーヴェ
Löwenig	レーヴェニヒ
Löwenthal	レーヴェンタール
Löwidth	レーヴィト
Löwlein	レーヴライン
Lübbecke	リュベッケ
Lübeck	リューベック
Lübke	リュプケ
Lücker	リュッカー
Luczeck	ルセック
Lüdeke	リュデケ
Luden	ルーデン
Ludendorff	ルーデンドルフ
Ludwig	ルートヴィヒ
Lueger	ルエーガー
Lüger	リューガー
Luhmann	ルーマン
Lummer	ルンマー
Lunge	ルンゲ
Luther	ルター
Lux	ルックス
Lynen	リネン
Magath	マガト
Mahler	マーラー
Mählich	メーリヒ
Mai	マイ
Maier	マイヤー
Maischberger	マイシュベルガー
Majdan	マイダン
Makatsch	マカチュ
Maltritz	マルトリッツ
Malz	マルツ
Mälzer	メルツァー
Mann	マン
Mannheim	マンハイム
Manninger	マニンガー
Manteuffel	マントイフェル
Marin	マーリン
Märkl	メルクル
Markull	マルクル
Marpurg	マルプルク
Marschall	マルシャル
Marschner	マルシュナー
Martenstein	マルテンシュタイン
Marx	マルクス
Matsch	マッチュ
Matthes	マッテス
Mattheson	マッテゾン
Mauer	マウアー
Maurer	マウラー
Max	マックス
Mayer	マイヤー
Mebert	メーベルト
Meggendorfer	メッゲンドルファー
Meichelbeck	マイヒェルベック
Meie	マイエ
Meier	マイアー
Meine	マイネ
Meinecke	マイネッケ
Meiser	マイザー
Meisner	マイスナー
Meitzen	マイツェン
Melanchthon	メランヒトン
Mendelsohn	メンデルゾーン
Mendelssohn	メンデルスゾーン
Mengelberg	メンゲルベルク
Merkel	メルケル
Mertens	メルテンス
Messerschmitt	メッサーシュミット
Messlender	メスレンダー
Messner	メスナー
Metternich	メッテルニヒ
Metzelder	メッツェルダー
Meyer	マイアー
Meyerheim	マイヤーハイム
Meysenbug	マイゼンブーク
Mezger	メツガー
Michaelis	ミヒャエリス
Michalke	ミヒャルケ
Millöcker	ミレッカー
Möbius	メービウス
Modersohn	モーダーゾーン
Mohler	モーラー
Mölders	メルダース
Möller	メーラー
Moltke	モルトケ
Monn	モン
Morgenstern	モルゲンシュテルン
Mottl	モットル
Mozart	モーツァルト
Mueller	ミュラー
Mühe	ミューエ
Mühlmeister	ミュールマイスター
Müller	ミュラー
Münch	ミュンヒ
Münchhausen	ミュンヒハウゼン
Müntefering	ミュンテフェーリング
Münter	ミュンター
Naumann	ナウマン
Necke	ネッケ
Neefe	ネーフェ
Nerlinger	ネルリンガー
Nessler	ネスラー
Netzer	ネッツァー
Neubauer	ノイバウアー
Neubert	ノイベルト
Neuendorf	ノイエンドルフ
Neuendorff	ノイエンドルフ
Neukomm	ノイコム
Neumann	ノイマン
Neumayer	ノイマイヤー
Neumeister	ノイマイスター
Neuneier	ノイナイアー
Neuner	ノイナー
Neurath	ノイラート
Neustädter	ノイシュテッター
Neutsch	ノイチュ
Niederhausen	ニーダーハウゼン
Nietzsche	ニーチェ
Nigbur	ニグブル
Noddack	ノダック
Nohl	ノール
Nommensen	ノメンゼン
Norden	ノルデン
Nordheim	ノルドハイム
Noske	ノスケ
Nottebohm	ノッテボーム
Nünke	ニュンケ
Ober	オーバー（オーベル）
Oberleitner	オーバーライトナー（オーベルライトナー）
Obermayer	オーバーマイヤー（オーベルマイヤー）
Oberstadt	オーベルシュタット、オーベアシュタット
Oberstolz	オーバーシュトルツ（オーベルシュトルツ）
Oechsler	エクスラー
Oelze	エルツェ
Oesten	エステン
Offterdinger	オフターディンガー
Ohlendorf	オーレンドルフ
Ohm	オーム
Oken	オーケン
Olbrich	オルブリヒ
Oldenberg	オルデンベルク
Ollenhauer	オレンハウアー
Oncken	オンケン
Opitz	オーピッツ
Oppel	オッペル
Oppenheim	オッペンハイム
Oppenheimer	オッペンハイマー
Oppolzer	オッポルツァー
Orff	オルフ
Orlob	オルロープ
Osiander	オジアンダー
Osthoff	オストホフ
Östmann	エストマン
Ostwald	オストヴァルト
Oswald	オスヴァルト
Othmayr	オトマイアー
Otto	オットー
Overbeck	オーフェルヴェック
Overweg	オーフェルヴェーク
Pabst	パプスト
Pachelbel	パッヘルベル
Pallasch	パラッシュ
Pape	パーペ
Papenroth	パーペンロート
Paproth	パップロート
Paradies	パラディース
Parenzan	パレンツァン
Paschen	パッシェン
Paschke	パシュケ
Pasemann	パーゼマン
Patitz	パーティツ
Patzig	パッツィーク
Pätzold	ペーツォルト
Patzsch	パッチュ
Paul	パウル
Paulmüller	パウルミュラー
Paulsen	パウルゼン
Paumann	パウマン
Paumgartner	パウムガルトナー
Paur	パウア
Pawelzig	パーヴェルツィーク
Paysen	パイゼン
Pech	ペヒ
Pechbrenner	ペヒブレンナー
Pechstein	ペヒシュタイン
Peger	ペーガー
Pellny	ペルニー
Peppel	ペッペル
Pepping	ペッピング
Perfall	ペルファル
Perl	ペルル
Perle	ペルレ
Perschmann	ペルシュマン
Pertz	ペルツ
Peschel	ペッシェル
Pestel	ペステル
Peters	ペーテルス
Petersen	ペーテルゼン
Petke	ペトケ
Petz	ペーツ
Peus	ポイス
Pezel	ペーツェル
Pfaffe	プファッフェ
Pfäffle	プフェッフレ
Pfeifenberger	プファイフェンベルガー
Pfeiffer	プファイファー
Pfennig	プフェニヒ、ペニヒ
Pfister	プフィスター、フィスター
Pfitzner	プフィッツナー
Pflug	プルーク
Pfluger	プフルーガー
Pflüger	プフリューガー
Pfuderer	プフデラー
Philippi	フィリッピ
Philipps	フィリップス
Pichler	ピヒラー
Pieck	ピーク
Pieckenhagen	ピッケンハーゲン
Piehl	ピール
Pielke	ピールケ
Pietack	ピータック
Pietsch	ピーチュ
Pietzcker	ピーツカー
Pisendel	ピゼンデル
Planert	プラネルト
Platenschläger	プラテンシュレーガー
Plätschke	プレチュケ
Platte	プラッテ
Plümacher	プリュマッハー
Pöbel	ペーベル
Pohle	ポーレ
Pöhlmann	ペールマン
Pölig	ペーリヒ
Polke	ポルケ
Pommerenke	ポンマーレンケ
Pönitz	ペーニッツ
Ponsel	ポンゼル
Poppeck	ポッペク
Pöppelmann	ペッペルマン
Porsch	ポルシュ
Pörschke	ペルシュケ
Poschner	ポシュナー
Pospich	ポスピッヒ
Possardt	ポッサート
Pötter	ペッター
Pozar	ポーツァル
Prädel	プレーデル
Präger	プレーガー
Prahl	プラール
Prahm	プラーム
Prange	プランゲ
Praschma	プラシュマ
Prätorius	プレトリウス
Precht	プレヒト
Prediger	プレーディガー
Preetz	プレーツ
Pregesbauer	プレゲスバウアー
Preiss	プライス
Preissel	プライセル
Preissler	プライスラー
Pretzsch	プレッチュ
Preu	プロイ
Preuss	プロイス
Preusse	プロイセ
Prillwitz	プリルヴィッツ
Pringsheim	プリングスハイム
Prinz	プリンツ
Prinzenzing	プリンツェンツィング
Probst	プロプスト
Proch	プロッホ
Pröll	プレル
Protze	プロッツェ
Puchert	プッヘルト
Püchot	ピュヒョ
Pügner	ピュークナー
Pulver	プルファー
Pupke	プープケ
Püttlingen	ピュットリンゲン
Pütz	ピュッツ
Quandt	クヴァント
Quantz	クヴァンツ
Raiffeisen	ライフアイゼン
Rainer	ライナー
Ranke	ランケ
Ratgeb	ラトギプ
Ratzel	ラッツェル
Ratzinger	ラッツィンガー
Rauch	ラウホ
Reclam	レクラム
Reeb	レープ
Reger	レーガー
Rehm	レーム
Rehmer	レーマー
Rehmke	レームケ
Reich	ライヒ
Reichardt	ライヒャルト
Reichen	ライヒェン
Reichenbach	ライヒェンバッハ
Reichenberger	ライヒェンベルガー
Reichstein	ライヒシュタイン
Reimann	ライマン
Rein	ライン
Reinders	ラインダース
Reinecke	ライネッケ
Reinfeldt	ラインフェルト
Reininger	ライニンガー
Reinmar	ラインマル
Reinmayr	ラインマイヤー
Reinthaler	ラインターラー
Reis	ライス
Reiser	ライザー
Reiß	ライス
Reissiger	ライシガー
Reiter	ライター
Reitmaier	ライトマイヤー
Renger	レンガー、レンゲル
Rennenkampf	レンネンカンプ
Renner	レンナー
Reppe	レッペ
Retz	レッツ
Reuchlin	ロイヒリン
Reuenthal	ロイエンタール
Reus	ロイス
Reussner	ロイスナー
Reuter	ロイター
Reutter	ロイター
Reyer	ライアー
Ribbentrop	リッベントロップ
Richter	リヒター
Richthofen	リヒトホーフェン
Ricken	リッケン
Rickert	リッケルト
Rieber	リーバー
Riedelstein	リーデルシュタイン
Riedle	リードレ
Riefenstahl	リーフェンシュタール
Riefensthal	リーフェンシュタール
Riegl	リーグル
Riehl	リール
Riemann	リーマン
Riemenschneider	リーメンシュナイダー
Ries	リース
Riess	リース
Rießle	リースレ
Riethmüller	リートミュラー
Rietschel	リーチェル
Rietz	リーツ
Rihm	リーム
Rilke	リルケ
Rische	リッシェ
Ritschl	リッチュル
Ritter	リッター
Ritz	リッツ
Rodenwald	ローデンヴァルト
Röder	レーダー
Rödiger	レディガー
Roehler	レーラー
Rohe	ローエ
Röhl	レール
Röhm	レーム
Röhrig	レーリヒ
Röhrl	レール
Rohwein	ローヴァイン
Romberg	ロンベルク
Römer	レマー
Rommel	ロンメル
Rönisch	レーニシュ
Röntgen	レントゲン
Rösch	レッシュ
Rösel	レーゼル
Rosenberger	ローゼンベルガー
Rosenhain	ローゼンハイン
Rosenheim	ローゼンハイム
Rosenkranz	ローゼンクランツ
Rosenmöller	ローゼンメラー
Rosenmüller	ローゼンミュラー
Rosenstiel	ローゼンシュティール
Rösinger	レージンガー
Rosler	ロスラー
Rössl	レースル
Rothenberger	ローテンベルガー
Rother	ローター
Röttgen	レトゲン
Röttger	レトガー
Rötzsch	レッチュ
Ruben	ルーベン
Rubens	ルーベンス
Rückert	リュッケルト
Rüdel	リューデル
Rüdiger	リュディガー
Ruge	ルーゲ
Rüggeberg	リュッゲベルク
Rühl	リュール
Rühle	リューレ
Rühm	リューム
Ruhnken	ルーンケン
Rümelin	リューメリン
Rummenigge	ルンメニゲ
Rumpf	ルンプ
Rundstedt	ルントシュテット
Runge	ルンゲ
Rünger	リュンガー
Rütgers	リュトガース
Rütters	リュッタース
Ruttmann	ルットマン
Sacher	ザッハー
Sachs	ザックス
Säckingen	ゼッキンゲン
Sägebrecht	ゼーゲブレヒト
Saldern	ザルデルン
Salmhofer	ザルムホーファー
Sammer	ザマー
Sander	ザンダー、ザンデル
Sauer	ザウアー
Sauerland	ザウアーラント
Saurbier	ザウルビーア
Saxer	ザクサー
Schache	シャッヘ、シャヘ
Schachner	シャハナー
Schacht	シャハト
Schädle	シェードレ
Schäfer	シェーファー
Schaffer	シャッファー
Schäkel	シェーケル
Schär	シェアー
Scharfenberg	シャルフェンベルク
Scharnhorst	シャルンホルスト
Schärtel	シェルテル
Schäuble	ショイブレ
Schauerte	シャウエルテ
Schaumann	シャウマン
Schaumburg	シャウムブルク
Schaür	シャウアー
Scheibe	シャイベ
Scheidemann	シャイデマン
Scheidl	シャイドル
Scheidt	シャイト
Schein	シャイン
Scheler	シェーラー
Schenk	シェンク
Schenkel	シェンケル
Scherbe	シェルベ
Scherenberg	シェーレンベルク
Scherz	シェルツ
Scheurer	ショイラー
Schiele	シーレ
Schierenbeck	シーレンベック
Schiffer	シッファー、シファー
Schiller	シラー
Schillings	シリングス
Schily	シリー
Schimpf	シンプ
Schindelmeisser	シンデルマイサー
Schindler	シントラー
Schindzielorz	シンジェロルツ
Schinkel	シンケル
Schirach	シーラッハ
Schittenhelm	シッテンヘルム
Schlegel	シュレーゲル
Schlegelmilch	シュレーゲルミルヒ
Schleich	シュライヒ
Schlemmer	シュレマー
Schlick	シュリック
Schlingensief	シュリンゲンジーフ
Schlöndorff	シュレンドルフ
Schlötter	シュレッター
Schlüter	シュリューター
Schmelzer	シュメルツァー
Schmidhammer	シュミットハンマー
Schmidt	シュミット
Schmiedel	シュミーデル
Schmitt	シュミット
Schmittbauer	シュミットバウアー
Schmolke	シュモルケ
Schnaas	シュナース
Schnabel	シュナーベル
Schneid	シュナイト
Schneider	シュナイダー
Schnelldorfer	シュネルドルファー
Schnitzler	シュニッツラー
Schnoor	シュノール
Schnorr	シュノッル
Schnuphase	シュヌップハーゼ
Schöber	シェーバー
Schöberl	シェーベール
Schoberlechner	ショーバーレヒナー
Schoder	ショーダー
Scholl	ショール
Schöllmann	シェルマン
Schönberg	シェーンベルク
Schöner	シェーナー
Schönheit	シェーンハイト
Schönherr	シェーンヘア
Schönstedt	シェーンシュテット
Schopenhauer	ショーペンハウアー
Schoppel	ショッペル
Schreck	シュレック
Schreiber	シュライバー
Schreker	シュレーカー
Schröder	シュレーダー
Schrödinger	シュレーディンガー
Schröter	シュレーター
Schroth	シュロート
Schubert	シューベルト
Schuessel	シュッセル
Schultz	シュルツ
Schulz	シュルツ
Schulze	シュルツェ
Schumacher	シューマッハー
Schumann	シューマン
Schur	シュール
Schuricht	シューリヒト
Schürmann	シュルマン
Schütte	シュッテ
Schütz	シュッツ
Schütze	シュッツェ
Schwarz	シュヴァルツ
Schwarzenbeck	シュヴァルツェンベック
Schwarzenberg	シュヴァルツェンベルク
Schwarzenegger	シュヴァルツェネガー
Schwarzkopf	シュヴァルツコップ
Schwarzmann	シュヴァルツマン
Schwarzschild	シュヴァルツシルト
Schwegler	シュヴェーグラー
Schweiger	シュヴァイガー
Schweigger	シュヴァイガー
Schweinfurth	シュヴァインフルト
Schweitzer	シュヴァイツァー
Schwenckfeld	シュヴェンクフェルト
Schwentke	シュヴェンケ
Schwichtenberg	シュヴィヒテンベルク
Schwiers	シュヴィアース
Sebald	ゼーバルト
Seebach	ゼーバッハ
Seebeck	ゼーベック
Seeckt	ゼークト
Seffern	ゼッフェルン
Seghers	ゼーガース
Seidel	ザイデル
Seifert	ザイフェルト
Seiger	ザイガー
Seitz	ザイツ
Seizinger	ザイツィンガー
Sekles	ゼクレス
Semper	ゼンパー
Seneelder	ゼーネフェルダー
Senkel	ゼンケル
Sertürner	ゼルチュルナー
Sesemann	ゼーゼマン
Sethe	ゼーテ
Seuse	ゾイゼ
Severing	ゼーフェリンク
Seyfried	ザイフリート
Siebel	ジーベル
Siegel	ジーゲル
Siegert	ジーゲルト
Sielmann	ジールマン
Silcher	ジルヒャー
Simens	ジーメンス
Simmel	ジンメル
Sohm	ゾーム
Solger	ゾルガー
Sombart	ゾンバルト
Sommer	ゾマー
Sommerfeld	ゾンマーフェルト
Sonne	ゾンネ
Sorge	ゾルゲ
Spamer	シュパーマー
Spann	シュパン
Sparwasser	シュパールヴァッサー
Speer	シュペーア
Spengler	シュペングラー
Spiekermann	シュピーケルマン
Spieler	シュピーラー
Spohr	シュポア
Spörl	シュペール
Springer	シュプリンガー
Stade	シュターデ
Städel	シュテーデル
Staden	シュターデン
Stahl	シュタール
Stahlberg	シュタールベルク
Stamitz	シュターミッツ
Stammler	シュタムラー
Stark	シュタルク
Starke	シュタルケ
Stauchenberg	シュタウヘンベルク
Staudinger	シュタウディンガー
Staupitz	シュタウピッツ
Stecher	シュテッヒャー
Steffens	シュテッフェンス
Stegmann	シュテーグマン
Steibelt	シュタイベルト
Steiert	シュタイアート
Stein	シュタイン
Steinach	シュタイナッハ
Steinauer	シュタイナウアー
Steindorff	シュタインドルフ
Steiner	シュタイナー
Steinfeld	シュタインフェルト
Steinmayer	シュタインマイヤー
Steinmetz	シュタインメッツ
Steppan	シュテッパン
Steppat	シュテッパート（ステパット）
Steude	シュトイデ
Stickroth	シュティークロート
Stieglitz	シュティークリッツ
Stiehl	シュティール
Stielike	シュティーリケ
Stifel	シュティーフェル
Stifter	シュティフター
Stilke	シュティルケ
Stiller	シュティラー
Stirner	シュティルナー
Stockhausen	シュトックハウゼン
Stöckigt	シュテッキヒト
Stöffler	シュテッフラー
Stöger	シュテーガー
Stoll	シュトール
Stoltzer	シュトルツァー
Stolz	シュトルツ
Stolze	シュトルツェ
Stölzel	シュテルツェル
Storm	シュトルム
Strantz	シュトランツ
Strasser	シュトラッサー
Strassmann	シュトラスマン
Straube	シュトラウベ
Straus	シュトラウス
Strauss	シュトラウス
Strehmel	シュトレーメル
Streich	シュトライヒ
Stresemann	シュレーゼマン
Strohmann	シュトローマン
Strunz	シュトルンツ
Stüben	シュトゥーベン
Stuckenschmidt	シュトゥッケンシュミット
Stumpf	シュトゥンプ
Stünzner	シュテュンツナー
Stutzmann	ストゥッツマン
Sucher	ズーハー
Sundermann	ズンダーマン
Täglichsbeck	テーグリヒスベック
Tannhäuser	タンホイザー
Tänzler	テンツラー
Tarnat	タルナート
Taubert	タウベルト
Täufer	トイファー
Teichmann	タイヒマン
Teichmüller	タイヒミュラー
Teike	タイケ
Telemann	テレマン
Teufel	トイフェル
Teyber	タイバー
Thalberg	タールベルク
Thälmann	テールマン
Thärichen	テーリヒェン
Thauer	タウアー
Theile	タイレ
Thiel	ティール
Thielemann	ティーレマン
Thieme	ティーメ
Thomamüller	トマミュラー
Thon	トーン
Thumann	トゥーマン
Thurnwald	トゥルンヴァルト
Tirpitz	ティルピッツ
Todt	トット
Tomböck	トンベック
Tönnies	テンニース（テニエス）
Tönnissen	テニッセン
Tospann	トスパン
Tostmann	トストマン
Träder	トレーダー
Träger	トレーガー
Trares	トラレス
Traut	トラウト
Trautmann	トラウトマン
Trautner	トラウトナー
Tremmel	トレンメル
Treu	トロイ
Troll	トロール
Tromlitz	トロムリッツ
Trost	トロスト
Trötschel	トレッチェル
Tuna	トゥーナ
Tunder	トゥンダー
Ubbelohde	ウッベローデ
Überschaar	ユーバシャール
Überweg	ユーベルヴェーク
Ueberschaar	ユーバシャール
Uffelmann	ウッフェルマン
Uhland	ウーラント
Uhlenhuth	ウーレンフート
Uhlig	ウーリヒ
Uhrmann	ウーアマン
Ulbl	ウルブル
Ulbrich	ウルブリヒ
Ulrich	ウルリヒ
Umbscheiden	ウムブシャイデン
Umlauf	ウムラウフ
Unger	ウンガー
Unkel	ウンケル
Unland	ウンラント
Untersberger	ウンタースベルガー
Unverzagt	ウンフェアツァークト
Urban	ウルバン
Urmersbach	ウルメルスバッハ
Utesch	ウテシュ
Veidt	ファイト
Veit	ファイト
Verleger	フェアリーガー
Vogel	フォーゲル
Vogler	フォーグラー
Vogt	フォクト
Vogts	フォクツ
Voigt	フォークト
Volbach	フォルバッハ
Völker	フェルカー
Volkmann	フォルクマン
Volland	フォラント
Völler	フェラー
Vollerthun	フォーレルトゥン
Vollmer	フォルマー
Volquartz	フォルクヴァルツ
Volz	フォルツ
Vorläufer	フォアロイファー
Wächter	ヴェヒター
Wackenroder	ヴァッケンローダー
Wagenseil	ヴァーゲンザイル
Wagner	ヴァーグナー（ワーグナー）
Wählte	ヴェールテ
Waigel	ヴァイゲル
Waitz	ヴァイツ
Walch	ヴァルヒ
Waldseemüller	ヴァルトゼーミュラー
Waldteufel	ヴァルトトイフェル
Waldvogel	ヴァルトフォーゲル
Wallach	ヴァラハ
Wallenstein	ヴァレンシュタイン
Wallnöfer	ヴァルネファー
Walpurgis	ヴァルプルギス
Walser	ヴァルザー
Walter	ヴァルター
Waltershausen	ヴァルタースハウゼン
Walterskirchen	ヴァルタースキルヒェン
Walther	ヴァルター
Walzel	ヴァルツェル
Wangenheim	ヴァンゲンハイム
Wank	ヴァンク
Warburg	ヴァールブルク
Wartenburg	ヴァルテンブルク
Wattenbach	ヴァッテンバッハ
Wätzlich	ベットリヒ
Weber	ヴェーバー
Webern	ヴェーベルン
Weckmann	ヴェックマン
Wedel	ヴェーデル
Wefers	ヴェーフェルス
Wegener	ヴェーゲナー
Wehlmann	ヴェールマン
Weidenfeller	ヴァイデンフェラー
Weidenhöfer	ヴァイデンヘーファー
Weidenreich	ヴァイデンライヒ
Weierstrass	ヴァイアーシュトラス（ワイエルシュトラス）
Weigel	ヴァイゲル
Weigl	ヴァイグル
Weikath	ヴァイカート
Weilandt	ヴァイラント
Weingartner	ヴァインガルトナー
Weinzierl	ヴァインツィアル
Weise	ヴァイゼ
Weisenborn	ヴァイゼンボルン
Weiser	ヴァイザー
Weisgerber	ヴァイスゲルバー
Weishaupt	ヴァイスハウプト
Weismann	ヴァイスマン
Weiss	ヴァイス
Weissenburg	ヴァイセンブルク
Weisshaupt	ヴァイスハウプト
Weisskopf	ヴァイスコップ
Weissmüller	ヴァイスミュラー
Weitling	ヴァイトリング
Weizsäcker	ヴァイツゼッカー
Weller	ヴェラー、ヴェッラー
Wellinger	ヴェリンガー
Wellmer	ヴェルマー
Welte	ヴェルテ
Welter	ヴェルター
Welzel	ヴェルツェル
Welzl	ヴェルツル
Wende	ヴェンデ
Wendel	ヴェンデル
Wenders	ヴェンデルス、ヴェンダース
Wentz	ヴェンツ
Wenzel	ヴェンツェル
Weppelmann	ヴェッペルマン
Werkmeister	ヴェルクマイスター
Werle	ヴェルレ
Werner	ヴェルナー
Wertmüller	ヴェルトミュラー
Wese	ヴェーゼ
Wessel	ヴェッセル
Wessels	ヴェッセルス
Wessely	ヴェッセリー
Wetz	ヴェッツ
Wetzel	ヴェッツェル
Widhölzl	ヴィドヘルツル
Wiechel	ヴィーヒェル
Wieck	ヴィーク
Wiedener	ヴィーデナー
Wieder	ヴィーダー
Wiegand	ヴィーガント
Wiegert	ヴィーゲルト
Wieland	ヴィーラント
Wiesinger	ヴィージンガー
Wietzel	ヴィーツェル
Wilcke	ヴィルケ
Wildenbruch	ヴィルデンブルホ
Wilder	ヴィルダー
Wilfert	ヴィルフェルト
Wilhelms	ヴィルヘルムス
Wilke	ヴィルケ
Willstätter	ヴィルシュテッター
Wimmer	ヴィンマー、ヴィマー
Wimpfeling	ヴィンプフェリング
Winckelmann	ヴィンケルマン
Winckler	ヴィンクラー
Windelband	ヴィンデルバンド
Windgassen	ヴィントガッセン
Windisch	ヴィンディッシュ
Wingerter	ヴィンゲルター
Winkel	ヴィンケル
Winkler	ヴィンクラー
Winter	ヴィンター
Winterhalter	ヴィンターハルター
Winternitz	ヴィンターニッツ
Wirth	ヴィルト
Wittgenstein	ヴィトゲンシュタイン
Witting	ヴィッティング
Wittmann	ヴィットマン
Wockenfuß	ヴォッケンフース
Wöhler	ヴェーラー
Wohlfahrt	ヴォールファールト
Wohmann	ヴォーマン
Wolf	ヴォルフ
Wolkenstein	ヴォルケンシュタイン
Wollitz	ヴォーリッツ
Wolschke	ヴォルシュケ
Wolters	ヴォルタース
Wörner	ヴェルナー
Wostmann	ヴォストマン
Wowereit	ヴォーヴェライト
Woyrsch	ヴォイルシュ
Wührer	ヴューラー
Wulff	ヴルフ
Wünschmann	ヴュンシュマン
Würzner	ヴュルツナー
Wüst	ヴュスト
Wüstemann	ヴュステマン
Wuttke	ヴットケ、ヴトケ
Zabel	ツァーベル
Zachau	ツァッハウ
Zallmann	ツァールマン
Zampach	ツァンパッハ
Zeiler	ツァイラー
Zeiss	ツァイス
Zeller	ツェラー
Zelter	ツェルター
Zender	ツェンダー
Zettel	ツェッテル
Zeyer	ツァイアー
Zickler	ツィックラー
Ziege	ツィーゲ
Ziehrer	ツィーラー
Zilcher	ツィルヒャー
Zimmermann	ツィマーマン、ツィンマーマン
Zischler	ツィシュラー
Zöbeley	ツェベライ
Zöllner	ツェルナー
Zuckmayer	ツックマイヤー
Zumpe	ツンペ
Zumsteeg	ツムシュテーク
Zur Mühlen	ツア・ミューレン
Zwanziger	ツヴァンツィガー
Zweig	ツヴァイク
Zweigle	ツヴァイクレ