Abélard	アベラール
Abraham	アブラーム
Achard	アシャール
Acquart	アキャール
Adam	アダン
Ader	アデール
Affré	アフレ
Afriat	アフリア
Aghion	アギヨン
Aillagon	アイヤゴン、アヤゴン
Aimard	エマール
Aimée	エメ
Alain	アラン
Albers	アルベール
Albert	アルベール
Albou	アルブー
Alkan	アルカン
Allain	アラン
Allais	アレ
Alléon	アレオン
Alliot	アリヨ
Althusser	アルチュセール
Ampère	アンペール
Amy	アミ
André	アンドレ
Anglade	アングラード
Anquetin	アンクタン
Antoine	アントワーヌ
Apollinaire	アポリネール
Appert	アペール
Arambourg	アランブール
Archer	アルシェ
Ardouin	アルドワン
Arnardi	アルナルディ
Arnaud	アルノー
Arnould	アルヌー
Aron	アロン
Arouet	アルエ
Artaud	アルトー
Arvier	アルヴィエ
Asselin	アスラン
Atget	アジェ
Attaignant	アテニャン
Attal	アタル
Auber	オベール
Aubert	オベール
Aubigné	オービニエ
Aubin	オーバン
Aubine	オビーヌ
Aubry	オーブリー、オブリ
Auclair	オクレール
Audin	オダン
Audollent	オードラン
Audran	オドラン
Auffret	オフレ
Augé	ウジェ
Auger	オジェ
Augier	オジエ
Aulard	オラール
Auric	オーリク
Auriol	オリオル、オリオール
Autin	オータン
Aveline	アヴリーヌ
Aymonier	エモニエ
Ayrault	エロー
Azéma	アゼマ
Aznavour	アズナヴール
Bachelard	バシュラール
Bachelet	バシュレ
Badinter	バダンテール
Bagieu	バジュー
Bahier	バイエ
Baillard	バイヤール
Baillot	バイヨ
Bailly	バイイ
Balabaud	バラボー
Balbastre	バルバストル
Balguerie	バルゲリー
Balladur	バラデュール
Balsan	バルサン
Baltel	バルテル
Barbet	バルベ
Barbier	バルビエ
Barbizet	バルビゼ
Barlier	バルリエ
Barnier	バルニエ
Baroin	バロワン
Barraine	バレーヌ
Barrande	バランド
Barraqué	バラケ
Barratier	バラチエ
Barraud	バロー
Barrault	バロー
Barré	バレ
Barreau	バロー
Barret	バレ
Barrier	バリエ
Barthélémy	バルテレミー
Barthes	バルト
Barthet	バルテ
Baschet	バシェ
Bastié	バスチエ
Bataille	バタイユ
Batigne	バティーニュ
Baton	バトン
Batté	バテ
Baud	ボー
Baudelaire	ボードレール
Baudouin	ボドワン
Baudrier	ボードリエ
Baudrillard	ボドリヤール、ボードリヤール
Baugé	ボージェ
Bayard	バヤール
Baye	バイ
Bayrou	バイルー
Bazaine	バゼーヌ
Bazelaire	バズレール
Bazin	バザン
Béart	ベアール
Béatrix	ベアトリクス
Beaucamp	ボーカン
Beaujon	ボージョン
Beaulieu	ボーリュー
Beaumarchais	ボーマルシェ
Beaumont	ボーモン
Beauvoir	ボーヴォワール
Becquerel	ベクレル
Becquet	ベケ
Becu	ベキュ
Bégaudeau	ベゴドー
Béjart	ベジャール
Bélanger	ベランジェ
Belges	ベルジュ
Belhomme	ベロム
Bellecourt	ベルクール
Belmont	ベルモン
Bénard	ベナール
Bénichou	ベニシュ
Benneteau	ベネトー
Benoit	ブノワ
Béranger	ベランジェ
Berchot	ベルショー
Bercot	ベルコ
Béreau	ベロー
Bergeron	ベルジュロン
Bergez	ベルジェ
Bergounioux	ベルグニウー
Berléand	ベルレアン
Berlioz	ベルリオーズ
Bernard	ベルナール
Berneux	ベルヌー
Bernier	ベルニエ
Berroyer	ベロワイエ
Bertheau	ベルトー
Berthier	ベルチエ（ベルティエ）
Berthollet	ベルトレ
Berthon	ベルトン
Berthoux	ベルトゥ
Bertin	ベルタン
Berton	ベルトン
Bertrand	ベルトラン
Besard	ブザール
Bescond	ベスコン
Besle	ベル
Bessières	ベシエール
Besson	ベソン
Bettencourt	ベタンクール
Beyle	ベイル
Beyron	ベイロン
Bichelberger	ビュシェルベルジェール
Bidault	ビドー
Bigard	ビガール、ビギャール
Bigot	ビゴー
Billard	ビヤール
Billaud	ビヨー
Billot	ビヨー
Biot	ビオ
Biron	ビロン
Bisson	ビソン
Bizet	ビゼー
Blaché	ブラシェ
Blachère	ブラシェール
Blachot	ブラショ
Blain	ブラン
Blanc	ブラン
Blanchard	ブランシャール
Blanche	ブランシュ
Blanchet	ブランシェ
Blanzat	ブランザ
Blareau	ブラロー
Blavet	ブラヴェ
Blondeau	ブロンドー
Blondel	ブロンデル
Blondin	ブロンダン
Blot	ブロ
Bobillier	ボビリエ
Bocuse	ボキューズ
Bodin	ボダン
Boieldieu	ボワエルデュー
Boileau	ボワロー
Boilley	ボワレー
Boisdeffre	ボワデフル
Boisguillebert	ボワギルベール
Boismortier	ボワモルチエ（ボワモルティエ）
Boiteux	ボワトゥ
Boivin	ボワヴァン
Bolliet	ボリエ
Bolling	ボラン
Bonfils	ボンフィス
Bonnard	ボナール
Bonnefoi	ボンフォワ、ボンヌフォワ
Bonnefoy	ボンヌフォワ、ボヌフォワ
Bonnet	ボネ
Bontout	ボントゥ
Borde	ボルド
Bordes	ボルデ
Borrel	ボレル
Bort	ボール
Borthayre	ボルテール
Boublil	ブーブリル
Boucaud	ブコー
Bouchardon	ブーシャルドン
Boucher	ブーシェ
Bouchet	ブシェ
Bouchez	ブシェ
Boudet	ブデ
Boudin	ブーダン
Bouffier	ブフィエ
Bouguereau	ブグロー（ブーグロー）
Bouin	ブアン
Bouix	ブイクス
Boulanger	ブランジェ、ブーランジェ
Boule	ブール
Boulez	ブレーズ
Bouquet	ブーケ
Bourbon	ブルボン
Bourdarias	ブルダリアス
Bourdelle	ブルデル
Bourdiau	ブルデュー
Bourdieu	ブルデュー
Bourdin	ブルダン
Bourdon	ブルドン
Boureau	ブーロー
Bourgault	ブルゴー
Bourgeat	ブルジェ
Bourgeois	ブルジョワ
Bourget	ブルジェ
Bourguignon	ブルギニョン
Bouroullec	ブルレック
Bourrienne	ブーリエンヌ
Bourzat	ブルザ
Bousquet	ブスケ
Boutard	ブタール
Boutherin	ブトラン
Boutin	ブタン
Boutonnat	ブトナ
Bouvet	ブヴェ
Bouvier	ブヴィエ
Boyer	ボワイエ
Bracquemond	ブラクモン
Brantôme	ブラントーム
Braque	ブラック
Brasilier	ブラジリエ
Braud	ブロー
Brault	ブロー
Breguet	ブルゲ
Brenin	ブルナン
Bret	ブレ
Breton	ブルトン
Bréval	ブレヴァル
Briand	ブリアン
Brocard	ブロカール
Brohly	ブローリ
Brossard	ブロサール
Brothier	ブロチエ
Brouillet	ブルイエ
Bruchollerie	ブリュショルリー
Brugnon	ブリュニョン
Brulé	ブリュレ
Bruneau	ブリュノー
Brunel	ブリュネル
Brunet	ブリュネ
Brunot	ブリュノ
Bruyère	ブリュイエール
Bucquet	ビュケ
Buffard	ビュファール
Buffet	ビュッフェ、ビュフェ
Buffin	ビュファン
Buffon	ビュフォン
Buillet	ビュイエ
Buisson	ビュイソン
Bullant	ビュラン
Bunlet	ビュンレ
Burles	ビュルル
Bussières	ビュシエール
Butor	ビュトール
Cabanel	カバネル
Cadiot	カディオ
Cagnard	カニャール
Cahen	カアン
Cahuzac	カユザク
Caillet	カイレ
Cailletet	カイユテ
Caix	ケ
Calmel	カルメル
Calvé	カルヴェ
Calvet	カルヴェ
Cambon	カンボン
Camboulives	カンブリーヴ
Camus	カミュ
Canteloube	カントルーブ
Cantet	カンテ
Caplet	カプレ
Capoul	カプール
Capuçon	カピュソン
Caradeux	カラドゥ
Carlier	カルリエ
Carmet	カルメ
Carné	カルネ
Carnot	カルノー
Caron	カロン
Carpentier	カルパンティエ
Carré	カレ
Carrère	カレール
Carrié	カリエ
Carrière	カリエール
Casadesus	カザドシュ
Castagnier	カスタニエ
Castaing	カステン
Castel	カステル
Caubère	コベール
Cauderlier	コデルリエ
Cavaignac	カヴェニャック
Cavet	カヴェ
Cayrol	ケロール
Cazauran	カゾーラン
Cazeneuve	カズヌーヴ
Cédolin	セドラン
Céline	セリーヌ
Cernay	セルネ
Certon	セルトン
Césaire	セザール
Cesbron	セスブロン
Cézanne	セザンヌ
Chabrier	シャブリエ
Chabroux	シャブルー
Chabrun	シャブラン
Chagnon	シャニョン
Chailley	シャイエ
Chalet	シャレ
Chalier	シャリエ
Chalou	シャルー
Chambon	シャンボン
Chaminade	シャミナード
Chamoiseau	シャモワゾー
Chamonin	シャモナン
Champollion	シャンポリオン
Chandernagor	シャンデルナゴール
Chanel	シャネル
Chanoine	シャノワーヌ
Chapdelaine	シャプドレーヌ
Chapelet	シャプル
Chappuis	シャピュイ
Chapuis	シャピュイ
Chardin	シャルダン
Charette	シャレット
Charlier	シャルリエ
Charlois	シャルロワ
Charpentier	シャルパンチエ、シャルパンティエ
Charrier	シャリエ
Charrière	シャリエール
Chartier	シャルチエ
Chartres	シャルトル
Chassagne	シャサーヌ
Châtaignier	シャテニエ
Chateaubriand	シャトーブリアン
Chaumont	ショモン
Chausson	ショーソン
Chaussonnière	ショーソンニエル
Chauveau	ショヴォー
Chauvet	ショーヴェ
Chauvin	ショヴァン、ショーヴァン
Chauviré	ショヴィレ
Chavannes	シャヴァンヌ
Chavenon	シャヴノン
Chelard	シュラール
Chemin	シュマン
Chenal	シュナル
Chéron	シェロン
Chevalier	シュヴァリエ
Chevènement	シュヴェーヌマン
Chevillard	シュヴィヤール
Chevrin	シュヴラン
Chintreuil	シャントルイユ
Chirac	シラク
Chrétien	クレチアン
Cixous	シクスー
Clair	クレール
Clapisson	クラピソン
Clarac	クララック
Claretie	クラルティ
Claudel	クロデル
Clavel	クラヴェル
Claverie	クラヴリー
Clémenceau	クレマンソー
Clément	クレマン
Clérambault	クレランボー
Clidat	クリダ
Cloquet	クロケ
Clouzot	クルーゾー
Cochet	コシェ
Cocteau	コクトー
Coeuriot	ケーリオ
Colbert	コルベール
Colette	コレット
Collard	コラール
Collasse	コラス
Collet	コレ
Colombe	コロンブ
Colonne	コロンヌ
Combes	コンベ
Command	コマン
Commette	コメット
Compain	コンパン
Comte	コント
Constant	コンスタン
Coquard	コカール
Coquereau	コケロー
Corbel	コルベル
Corbusier	コルビュジエ
Corneille	コルネイユ
Cornu	コルニュ
Cornut	クールニュ
Corot	コロー
Corrette	コレット
Cortot	コルトー
Cottavoz	コタヴォ
Coty	コチ、コティ
Coubertin	クーベルタン
Coulet	クレ
Coulon	クーロン
Couperin	クプラン
Courand	クーラン
Courbet	クールベ
Courboin	クルボワン
Cournand	クールナン
Courrèges	クレージュ、クーレージュ
Cousin	クザン
Cousteau	クストー
Couturier	クチュリエ
Couve	クーヴ
Couvreur	クヴルール
Couzinet	クジネ
Couzinou	クジヌー
Crepel	クレペル
Cresson	クレソン
Croiset	クロワゼ
Croze	クローズ
Curie	キュリー
Cuvier	キュヴィエ
d'Aiguebelle	デグベル
d'Angers	ドンジェ
D'Anglebert	ダングルベール
D'Archiac	ダルシアク
D'Arco	ダルコ
D'Aubigné	ドービニエ
d'Estaing	デスタン
D'Ezamy	デザミー
d'Hérelle	デレル
D'Indy	ダンディ
D'Ivry	ディヴリー
D'Ollone	ドローヌ
D'Orbigny	ドルビニー
d'Urfé	デュルフェ
Dabit	ダビ
Daguerre	ダゲール
Dalayrac	ダレイラク
Dallier	ダリエ
Damase	ダマーズ
Dambier	ダンビエ
Dandelot	ダンドロ
Dandrieu	ダンドリュー
Danton	ダントン
Daquin	ダカン
Darasse	ダラス
Darcey	ダルセー
Dardenne	ダルデンヌ
Dárdespin	ダルデスパン
Darondeau	ダロンド
Darré	ダルレ
Darthou	ダルトゥ
Dartois	ダルトワ
Daubenton	ドーバントン
Daumier	ドーミエ
Dauphin	ドーファン
Dausset	ドーセ
Dautin	ドータン
Dauvergne	ドーヴェルニュ
David	ダヴィド
Davout	ダヴー
Dayan	ダヤン
de Broglie	ド・ブロイ
de Gennes	ド・ジェンヌ
de L'Isle	ド・リール
de Villepin	ド・ヴィルパン
Debary	ドバリー
Debout	ドゥボー
Debray	ドゥブレー
Debré	ドブレ
Debreu	ドブルー
Debussy	ドビュッシー
Decaix	ドゥケ
Decaux	ドコー
Dechamps	ドゥシャン
Dechaud	ドゥショー
Dechy	ドゥシー、ドシー
Décugis	デキュジ
Deffand	ドゥファン
Degas	ドゥギャ（ドガ）
Degletagne	ドゥグルターニュ
Dehesdin	ドゥエスダン
Delacroix	ドゥラクロワ、ドラクロワ
Delage	デラージュ
Delalande	ドゥラランド
Delambre	ドランブル
Delamétherie	ドゥラメトリー
Delannoy	ドゥラノワ
Delanoë	ドラノエ
Delaunay	ドローネー
Delépine	ドゥレピーヌ
Delerue	ドルリュー
Delibes	ドリーブ
Delmas	ドゥルマ
Delon	ドロン
Delorme	ドロルム
Delors	ドロール
Delvincourt	デルヴァンクール
Demougeot	ドゥムジョ
Demy	ドゥミ
Deneuve	ドヌーヴ、ドゥヌーヴ
Denève	ドゥネーヴ
Denier	ドニエ
Denis	ドゥニ
Denize	ドゥニーズ
Depardieu	ドパルデュー
Depardon	ドパルドン
Deplace	ドゥプラス
Depraz	ドゥプラ
Deprez	ドゥプレ
Derain	ドラン
Deray	ドレー
Derrida	デリダ
Desailly	デサイー
Desargues	デザルグ
Desbats	デバ
Desbordes	デボルド
Descartes	デカルト
Descaves	デカーヴ
Deschamps	デシャン
Deschanel	デシャネル
Descharmes	デシャルム
Desforge	デフォルジュ
Desforges	デフォルジュ
Désir	デジール
Deslongchamps	デロンシャン
Deslot	デロ
Desmarets	デマレ
Desmoulins	デムラン
Desnos	デスノス
Despeaux	デポー
Despiau	デスピオ
Desthieux	デスチュー
Destouches	デトゥーシュ
Devauchelle	ドゥヴォシェル
Devaux	ドヴォー
Devienne	ドヴィエンヌ
Devos	ドヴォス
Devouassoux	ドゥーヴアスー
Devoyon	ドヴォワヨン
Diderot	ディドロ
Didier	ディディエ
Dieudonné	デュドネ
Dieulafoy	デュラフォア
Dieupart	デュパール
Dintrich	ダントリク
Dior	ディオール
Djian	ジアン
Donatien	ドナシアン
Dondeyne	ドンディーヌ
Donon	ドノン
Dopffer	ドプフェール
Doré	ドレ
Dorin	ドラン
Dorléac	ドルレアク
Dosse	ドッス
Doucet	ドゥーセ
Doumer	ドゥメール
Doumergue	ドゥメルグ
Douroux	ドゥルー
Doursoux	ドゥルスー
Douste	ドゥスト
Douvillé	ドゥヴィレ
Doyen	ドワイヤン
Drapeau	ドラポー
Drolet	ドロレ
Druille	ドルイユ
du Bellay	デュ・ベレー
du Bois	デュ・ボワ、デュ・ボア
du Caurroy	デュ・コロワ
du Guesclin	デュ・ゲクラン
Dubet	デュベ
Dubois	デュボワ、デュボア
Dubuffet	デュビュッフェ
Dubuis	デュビュイ
Duby	デュビ
Ducasse	デュカス
Duchamp	デュシャン
Duchemin	デュシュマン
Duchesnay	デュシュネ
Duchesne	デュシェーヌ
Duclos	デュクロ
Ducos	デュコ
Ducoudray	デュクドレー
Ducrocq	デュクロク
Ducrot	デュクロ
Dudevant	デュドヴァン
Dudouet	デュドゥエ
Dufaure	デュフォール
Dufaux	デュフォー
Dufour	デュフール
Dufourcq	デュフルク
Dufresne	デュフレーヌ
Dufy	デュフィ
Dughet	デュゲ
Dugué	デュゲ
Duguit	デュギー
Duhem	デュエム
Dujardin	デュジャルダン
Dulac	デュラク
Dullin	デュラン
Dulong	デュロン
Duma	デュマ
Dumas	デュマ
Duméry	デュメリー
Dumond	デュモン
Dumont	デュモン
Dumortier	デュモルチエ
Dumouriez	デュムーリエ
Dunan	デュナン
Dunant	デュナン
Dunois	デュノア
Dunoyer	デュノアイエ
Duparc	デュパルク
Dupin	デュパン
Dupleix	デュプレクス
Duplessis	デュプレシ
Dupont	デュポン
Duport	デュポール
Dupouy	デュプイ
Dupré	デュプレ
Dupressoir	デュプレソワール
Dupuis	デュピュイ
Dupuytren	デュピュイトラン
Durand	デュラン
Durey	デュレー
Durivault	ドゥリヴォー
Durkheim	デュルケーム
Durrenberger	デュランベルジェ
Duruflé	デュリュフレ
Duruy	デュリュイ
Dussaut	デュソー
Dussolier	デュソリエ
Dutilleux	デュティユー
Dutoit	デュトワ
Duval	デュヴァル
Duvalier	デュヴァリエ
Duvergier	デュヴェルジェ
Duvernoy	デュヴェルノワ
Duvillard	デュヴィラール
Duvillier	デュヴィーエ
Duvivier	デュヴィヴィエ
Eiffel	エッフェル
Eloy	エロワ
Éluard	エリュアール
Emmanuel	エマニュエル
Epée	エペー
Erlanger	エルランジェ
Ernaux	エルノー
Escoffier	エスコフィエ
Estienne	エチエンヌ
Estrées	エストレ
Ethuin	エテュアン
Evrard	エヴラール
Fabius	ファビウス
Fache	ファシュ
Faisandier	フェザンディエ
Faivre	フェーヴル
Falguière	ファルギエール
Fallières	ファリエール
Fallot	ファロ
Faucomprez	フォーコンプレ
Fauconnet	フォーコネ
Faure	フォール
Fauré	フォレ、フォーレ
Fautrel	フォートレル
Fautrier	フォートリエ
Fénéon	フェネオン
Fer	フェル
Ferrer	フェレール
Ferrier	フェリエ
Feuillade	フイヤード
Févin	フェヴァン
Feydeau	フェドー
Fillon	フィヨン
Finel	フィネル
Fiquet	フィケ
Fizeau	フィゾー
Flaubert	フロベール
Flavigny	フラヴィニー
Fleury	フルーリー
Floquet	フロケ
Fontaine	フォンテーヌ
Fontanier	フォンタニエ
Fontbrune	フォンブリューヌ
Forge	フォルジュ
Forget	フォルジェ
Forqueray	フォルクレ
Fort	フォル
Fortant	フォルタン
Fortier	フォルチエ
Fortin	フォルタン
Foucault	フーコー
Fourcade	フルカード
Fourdrain	フールドラン
Fourier	フーリエ
Fournier	フルニエ
Fragonard	フラゴナール
Fraipont	フレポン
France	フランス
Francell	フランセル
Francœur	フランクール
Francy	フランシ
Frémont	フレモン
Fremy	フレミー
Frion	フリオン
Froumenty	フルマンティ
Fugain	フュギャン
Gabin	ギャバン
Gaboriau	ガボリオ、ギャボリオ
Gabriel	ギャブリエル、ガブリエル
Gadenne	ガダンヌ
Gaillard	ガイヤール
Gailly	ガイイ
Gall	ギャル
Gallienne	ギャリエンヌ
Gallimard	ガリマール
Gallois	ギャロワ
Galois	ギャロワ
Galpérine	ギャルペリーヌ
Galvin	ギャルヴァン
Ganne	ギャンヌ
Gardon	ギャルドン
Garnerin	ガルヌラン
Garnier	ギャルニエ（ガルニエ）
Gasquet	ガスケ
Gattegno	ガッテニョ
Gaubert	ゴーベール
Gaudin	ゴダン
Gauguin	ゴーギャン
Gaulle	ゴール
Gaultier	ゴルチエ
Gaumond	ゴーモン
Gaumont	ゴーモン、ゴモン
Gauthier	ゴーチエ
Gautier	ゴーチエ
Gavoty	ガヴォティ
Gayet	ガイエ、ギャイエ
Gebel	ジュベル
Gédéon	ジェデオン
Gélin	ジェラン
Geliot	ジュリオ
Géliot	ジェリオ
Gellée	ジュレ
Gendron	ジャンドロン
Geneste	ジュネスト
Genet	ジュネ
Gens	ジャン
Geoffray	ジョフレ
Geoffroy	ジョフロワ
Georges	ジョルジュ
Gérard	ジェラール
Gerardin	ジェラルダン
Gerbault	ジェルボー
Gerét	ジェレ
Géricault	ジェリコー
Germain	ジェルマン
Gérôme	ジェローム
Gervais	ジェルヴェ
Gervaise	ジェルヴェーズ
Giardino	ジャルディノ
Gicquel	ジケル
Gide	ジード、ジッド
Gignoux	ジヌー
Gigot	ジゴー
Gil	ジル
Gilibert	ジリベール
Gilleron	ジルロン
Gillet	ジレ
Gillot	ジロ
Gilly	ジリー
Gionnet	ジオネ
Giono	ジオノ
Girard	ジラール
Girardet	ジラルデ
Girardière	ジラルディエール
Giraud	ジロー
Giraudeau	ジロドー
Giraudoux	ジロドゥー
Giroud	ジルー
Giroux	ジルー
Giscard	ジスカール
Givet	ジヴェ
Gobert	ゴベール
Godard	ゴダール
Godefroy	ゴドフロワ
Gontier	ゴンティエ、ゴンチエ
Goron	ゴロン
Gossec	ゴセック
Goudier	グディエ
Goudimel	グーディメル
Gounod	グノー
Gousseau	グソー
Gracq	グラック
Grandet	グランデ
Granet	グラネ
Grange	グランジュ
Grangé	グランジェ
Granier	グラニエ
Granlin	グランラン
Grasset	グラッセ
Grémillon	グレミヨン
Gresse	グレッス
Grévy	グレヴィ
Griette	グリエット
Grigny	グリニー
Grimault	グリモー
Grisolet	グリゾレ
Grosjean	グロジャン
Groult	グルー
Grovlez	グロヴレ
Guedron	ゲドロン
Gueneau	グノー
Guerchet	ゲルシェ
Guérin	ゲラン
Guerlain	ゲラン
Guers	ゲール
Guesde	ゲッド、ゲード
Guesnier	ゲニエ
Guffroy	ギュフロワ
Gui	ギー
Guibert	ギベール
Guigou	ギグー
Guillard	ギヤール
Guille	ギーユ
Guillemette	ギユメット
Guillemin	ギユマン
Guillermin	ギェルマン
Guillet	ギレ
Guillon	ギヨン
Guillot	ギヨー
Guilloux	ギユー
Guilmant	ギルマン
Guilmette	ギルメット
Guimard	ギマール
Guimet	ギメ
Guin	ギャン
Guiot	ギオー
Guiramand	ギラマン
Guiraud	ギロー
Guivarc'h	ギヴァルシュ
Guy	ギュイ
Guynemer	ギヌメール
Guyotat	ギヨタ
Haber	アベール
Habert	アベール
Hache	アッシュ、アーシュ
Haffner	アフネル
Hamelin	アムラン
Hardouin	アルドワン
Harlaut	アルロー
Harnois	アルノワ
Haroche	アロシュ
Hasselmans	アセルマン
Haussmann	オスマン
Haüy	アウイ
Hazard	アザール
Hebert	エベール
Hecquefeuille	エクフイユ
Heldy	エルディー
Helffer	エルフェ
Helvétius	エルヴェシウス
Hémar	エマール
Hémard	エマール
Hémery	エマリー
Hémon	エモン
Hénin	エナン
Henin	エナン
Henri	アンリ
Henriot	アンリオ
Henry	アンリ
Herail	エライユ
Herbet	エルベ
Hérent	エラン
Hermés	エルメス
Hermite	エルミート
Héroult	エルー
Herpe	エルプ
Herriot	エリオ
Hervieu	エルヴィユ
Hillemacher	イルマシェ
Hivert	イヴェール
Hoche	オシュ
Hodeir	オデール
Hollande	オランド
Hotteterre	オトテール
Houdart	ウダール
Houdon	ウードン
Houtmann	ウトマン
Hovora	オヴォラ
Hubeau	ユボー
Huberdeau	ユベルドー
Hubert	ユベール
Hugo	ユゴー
Hugoniot	ユゴニオ
Humbert	アンベール
Humel	ユメル
Huré	ユレ
Hureau	ユロー
Hutin	ユタン
Ibert	イベール
Ingres	アングル
Jacob	ジャコブ
Jacquard	ジャカール
Jacqueminot	ジャックミノー
Jacquet	ジャケ
Jacquillat	ジャキヤ
Jacquin	ジャッカン
Jaffre	ジャフル
Jalbert	ジャルベール
Jamet	ジャメ
Jamin	ジャマン
Janequin	ジャヌカン
Jaquet	ジャッケ
Jarre	ジャール
Jean	ジャン
Jeanmaire	ジャンメール
Jeannot	ジャノ
Jeunet	ジュネ
Joachim	ジョアシャン
Jobert	ジョベール
Johanneau	ジョアンノー
Johaux	ジュオー
Joinville	ジョアンヴィル
Joliot	ジョリオ
Jolivet	ジョリヴェ
Jonas	ジョナ
Jonquet	ジョンケ
Jospin	ジョスパン
Josserand	ジョスラン
Jouan	ジュアン
Jouatte	ジュアット
Joubert	ジュベール
Jouin	ジュアン
Jouineau	ジュイノー
Jourdain	ジョルダン
Jouve	ジュヴェ
Joxe	ジョクス
Joy	ジョワ
Jugnot	ジュニョ
Juppé	ジュペ、ジュッペ
Karembeu	カランブー
Koechlin	ケクラン
La Bruchollerie	ラ・ブリュショルリ
La Fayette	ラ・ファイエット
La Fontaine	ラ・フォンテーヌ
La Forge	ラ・フォルジュ
La Halle	ラ・アル
La Salle	ラ・サル、ラ・サール
La Tour	ラ・トゥール
Labarre	ラバール
Labey	ラベー
Labracherie	ラブラシュリ
Labré	ラブレ
Lacan	ラカン
Lacepede	ラスペード
Lacheray	ラシュレー
Laclos	ラクロ
Lacombe	ラコンブ
Lacordaire	ラコルデール
Lacoste	ラコスト
Lacour	ラクール
Lacretelle	ラクルテル
Lacroix	ラクロワ
Laënnec 	ラエネック、レーネック
Lafargue	ラファルグ
Laffont	ラフォン
Lafond	ラフォン
Lafont	ラフォン
Laforet	ラフォレ
Lagarde	ラガルド
Lagrange	ラグランジュ
Laguiller	ラギエ
Laheurte	ラウルト
Laine	レーヌ
Lainé	レネ
Lalande	ラランド
Lallouette	ラルエット
Lalo	ラロ
Lalonde	ラロンド
Lamartine	ラマルチーヌ
Lambert	ランベール
Lamblin	ランブラン
Lamy	ラミー
Landreau	ランドロー
Langlais	ラングレー
Langlois	ラングロワ
Lannes	ランヌ
Lanvin	ランヴァン
Laparra	ラパラ
Lapelletrie	ラペルトリ
Lapeyrette	ラペイレット
Laplace	ラプラス
Lapointe	ラポワント
Lapoirie	ラポワリー
Laporte	ラポルト
Lapparent	ラッパラン
Laprade	ラプラード
Larcange	ラルカンジュ
Laroche	ラロシュ
Laroque	ラロク
Larrieu	ラリュー
Lassagne	ラサーニュ
Lassalle	ラサル
Lathière	ラチエール
Laurant	ローラン
Laurence	ロランス
Laurencin	ローランサン
Laurent	ローラン
Lautrec	ロートレック
Laval	ラヴァル
Lavandier	ラヴァンディエ
Laveran	ラヴラン
Lavillenie	ラヴィルニー
Lavisse	ラヴィス
Lavoie	ラヴォワ
Lavoisier	ラヴォアジエ
Le Begue	ル・ベーグ
Le Bel	ル・ベル
Le Bon	ル・ボン
Le Breton	ル・ブルトン
Le Bris	ル・ブリ
Le Brun	ル・ブラン
Le Carrié	ル・カリエ
Le Chapelier	ル・シャプリエ
Le Chatelier	ル・シャトリエ
Le Clézio	ル・クレジオ
Le Comte	ル・コント
Le Conte	ル・コント
Le Flem	ル・フレム
Le Fort	ル・フォール
Le Gall	ル・ギャル
Le Gallienne	ル・ギャリエンヌ
Le Goff	ル・ゴフ
Le Jeune	ル・ジュヌ
Le Nain	ル・ナン
Le Nôtre	ル・ノートル
Le Pen	ル・ペン
Le Play	ル・プレー
Le Riche	ル・リッシュ
Le Roux	ル・ルー
Le Roy	ル・ロワ、ル・ロア
Le Sueur	ル・スュール
Le Tellier	ル・テリエ
Le Vau	ル・ヴォー
Le Verrier	ル・ヴェリエ
Léandre	レアンドル
Léautaud	レオトー
Lebarbé	ルバルベ
Lebesgue	ルベーグ
Leblanc	ルブラン
Leboeuf	ルブーフ
Lebreton	ルブルトン
Lebrun	ルブラン
Lecat	ルカ
Leclair	ルクレール
Leclerc	ルクレール
Leclercq	ルクレール
Lecocq	ルコック
Lecomte	ルコント
Leconte	ルコント
Lecouvreur	ルクヴルール
Ledoux	ルドゥー
Ledoyen	ルドワイヤン
Ledru	ルドリュ
Leduc	ルデュク
Lefait	ルフェ
Lefèbvre	ルフェーヴル
Lefebvre	ルフェーヴル
Lefèvre	ルフェーヴル
Lefort	ルフォール
Legendre	ルジャンドル
Léger	レジェ
Legrand	ルグラン
Lejeune	ルジュヌ
Lelong	ルロン
Lelouch	ルルーシュ
Lemaire	ルメール
Lemaïtre	ルメートル
Lemare	ルマール
Lemercier	ルメルシエ
Lemoigne	ルモワーニュ
Lemonnier	ルモニエ
Lemoyne	ルモワーヌ
Lengellé	ランジュレ
Lenglen	ラングラン
Lenoir	ルノアール
Léotard	レオタール
Lepape	ルパープ
Lerner	レルネ
Leroux	ルルー
Leroy	ルロワ
Lesage	ルサージュ
Lescot	レスコー
Lespinasse	レスピナス
Lesseps	レセップス
Lesueur	ルスュール
Lesur	ルスュール、ルシュール
Leurquin	レルカン
Leverrier	ルヴェリエ
Lévi	レヴィ
Lévy	レヴィ
Lièvre	リエーヴル
Lifar	リファール
Ligne	リーニュ
Lilamand	リラマン
Lionne	リオンヌ
Liouville	リウヴィル
Lisnard	リスナール
Lissajous	リサジュー
Littré	リトレ
Loaëc	ロアエク
Logerot	ロジュロ
Loilier	ロワリエ
Lolotte	ロロット
Londeix	ロンデックス
Long	ロン
Loraux	ロロー
Loriod	ロリオ
Lorioux	ロリウー
Lormeau	ロルモー
Loubet	ルベ
Louboutin	ルブタン
Loucheur	ルシュール
Loussier	ルシエ
Louvier	ルヴィエ
Louvois	ルヴォア
Louÿs	ルイス
Loyonnet	ロヨネ
Lubin	リュバン
Lucas	リュカ
Luchaire	リュシェール
Lucidor	リュシドール
Lully	リュリ
Lumière	リュミエール
Luneau	リュノー
Lupin	リュパン
Macaire	マケール
Machaut	マショー
Maclet	マクレ
Macron	マクロン
Maginot	マジノ
Magnard	マニャール
Magnat	マグナ、マニャ
Magnien	マニアン
Mahaut	マオー
Maillard	マイヤール
Maillet	マイエ
Maimbourg	マンブール
Maintenon	マントノン
Mairesse	メレス
Maison	メゾン
Malabre	マラブル
Malaure	マロール
Malbert	マルベール
Mâle	マール
Malebranche	マルブランシュ（マールブランシュ）
Malet	マレ
Malgoire	マルゴワール
Malherbe	マレルブ
Mallarmé	マラルメ
Malle	マル
Malot	マロ
Malraux	マルロー
Malus	マリュス
Manchet	マンシェ
Mandiargues	マンディアルグ
Mandroux	マンドルー
Manet	マネ
Maneveau	マヌヴォー
Manificat	マニフィカ
Mansart	マンサール
Mantoux	マントゥー
Manuel	マニュエル
Marais	マレ
Marant	マラン
Maratier	マラチエ
Marcel	マルセル
Marchais	マルシェ
Marchand	マルシャン
Marchex	マルシェ
Marcoux	マルクー
Maréchal	マレシャル
Marie	マリー、マリ
Marielle	マリエル、マリエール
Marien	マリアン
Mariette	マリエット
Marinel	マリネル
Marion	マリオン
Mariotte	マリオット
Maritain	マリタン
Marius	マリユス
Marivaux	マリヴォー
Marliave	マルリアーヴ
Marlin	マルラン
Marmol	マルモル
Marmont	マルモン
Marmontel	マルモンテル
Marmottan	マルモッタン
Marot	マロ
Marquerie	マルクリー
Marquet	マルケ
Marteau	マルトー
Martenot	マルトノ
Martin	マルタン
Martinod	マルチノ
Martinon	マルチノン
Marty	マルティ
Martyl	マルティル
Mascart	マスカール
Massé	マセ
Massenet	マスネ
Masseron	マスロン
Massias	マシア
Masson	マソン
Mathieu	マチュー
Mathis	マチス
Matisse	マチス、マティス
Mauclair	モクレール
Mauduit	モデュイ
Mauffroy	モフロワ
Maulny	モルニー
Maunier	モニエ
Maupassant	モーパッサン
Mauriac	モーリアック
Mauriat	モーリア
Maurin	モラン
Mauroy	モーロワ
Mazarin	マザラン
Mazellier	マズリエ
Méchain	メシャン
Megret	メグレ
Mélenchon	メランション
Merchet	メルシェ
Mercier	メルシエ
Mereaux	メロー
Mérimée	メリメ
Merleau	メルロー
Merlet	メルレ
Mermet	メルメ
Mermillod	メルミヨ
Mersenne	メルセンヌ
Mesplé	メスプレ
Messager	メサジェ
Messiaen	メシアン
Messier	メシエ
Meunier	ムニエ
Meyer	メイエ
Micheau	ミショー
Michel	ミシェル
Michelet	ミシュレ
Michelin	ミシュラン
Midol	ミドル
Mignerey	ミニョレー
Migot	ミゴー
Milhaud	ミヨー
Millerand	ミルラン
Millet	ミレー
Minaux	ミノー
Miotte	ミオット
Mirbeau	ミルボー
Missa	ミッサ
Missillier	ミシリエ
Mistral	ミストラル
Mitterrand	ミッテラン
Moderne	モデルヌ
Moineau	モワノ、モワノー
Molière	モリエール
Molko	モルコ
Mollet	モレ
Monange	モナンジュ
Moncey	モンセイ
Mondonville	モンドンヴィル
Monet	モネ
Monge	モンジュ
Monod	モノ
Monpou	モンプー
Monsigny	モンシニ
Montagne	モンターニュ
Montagné	モンタニエ
Montagnier	モンタニエ
Montaigne	モンテーニュ
Montalembert	モンタランベール
Montand	モンタン
Montespan	モンテスパン
Montesquieu	モンテスキュー
Montet	モンテ
Montgolfier	モンゴルフィエ
Montherlant	モンテルラン
Monthlon	モントロン
Monvoisin	モンヴォワザン
Morand	モラン
Morax	モラクス
Moreau	モロー
Morel	モレル
Morignat	モリニャ
Morin	モラン
Morisot	モリゾー
Mortier	モルチエ
Morvan	モルヴァン
Mouchez	ムーシェ
Mouillard	ムイヤール
Mouille	ムイユ
Moulévrier	ムーレヴリエ
Moulin	ムーラン
Mouret	ムーレ
Muhl	ミュール
Murail	ミュレル
Muraise	ミュレーズ
Murat	ミュラ
Murator	ミュラトール
Muret	ミュレ
Murville	ミュルヴィル
Musset	ミュッセ
Navarre	ナヴァール
Navier	ナビエ
Néel	ネール
Nerval	ネルヴァル
Neveu	ヌヴー
Nibelle	ニベル
Nicod	ニコ
Nicolas	ニコラ
Nicole	ニコル
Nicoullaud	ニクロー
Nivers	ニヴェール
Nodier	ノディエ
Noé	ノエ
Noë	ノエ
Noël	ノエル
Noémi	ノエミ
Nogaret	ノギャレ
Nollet	ノレ
Nounou	ヌヌー
Noverre	ノヴェール
Oblin	オブラン
Ohana	オハナ
Olivétan	オリヴェタン
Olivier	オリヴィエ
Ollier	オリエ
Ollivier	オリヴィエ
Orange	オランジュ
Oresme	オレスム
Osouf	オスーフ
Ossard	オサール
Othoniel	オトニエル
Oudinot	ウディノ
Ousset	ウセ
Ozenfant	オザンファン
Pagès	パジェス
Pagis	パジ
Paillard	パイヤール
Paille	パイユ
Painlevé	パンルヴェ
Paire	ペール
Paladilhe	パラディール
Panel	パネル
Panseron	パンスロン
Pantillon	パンティヨン
Paquier	パキエ
Paré	パレ
Parienté	パリアンテ
Parillaud	パリヨー
Paris	パリ
Pasdeloup	パドルー
Pasquier	パスキエ
Passemard	パスマール
Pasteur	パストゥール
Pauchard	ポーシャール
Pautrier	ポートリエ
Péchalat	ペシャラ
Pellegrin	ペルグラン
Pellerin	ペルラン
Pelletier	ペルチエ（ペルティエ）
Pellissier	ペリシエ
Peltier	ペルチエ（ペルティエ）
Penassou	ペナスー
Percier	ペルシエ
Périer	ペリエ
Pernet	ペルネ
Perrault	ペロー
Perret	ペレ
Perriand	ペリアン
Perrier	ペリエ
Perrillat	ペリヤ
Perrin	ペラン
Perron	ペロン
Perront	ペロン
Perroy	ペロワ
Persuis	ペルスュイ
Pessard	ペサール
Pessiot	ペシオ
Pétain	ペタン
Petibon	プチボン
Pétin	ペタン
Petit	プチ
Peynet	ペイネ
Pflimlin	フリムラン
Philidor	フィリドール
Philip	フィリップ
Piau	ピオー
Picard	ピカール
Pichon	ピション
Pierne	ピエルネ
Pierrat	ピエラ
Pierre	ピエール
Pierron	ピエロン
Pignier	ピニエ
Pilâtre	ピラートル
Pinard	ピナール
Pinturault	パンチュロー
Pioche	ピオシュ
Pioger	ピオジェ
Pisan	ピザン
Pitre	ピトル
Planquette	プランケット
Plantade	プランタード
Plasseraud	プラスロー
Pleven	プレヴァン
Pludermacher	プリュデルマシェ
Poincaré	ポワンカレ、ポアンカレ
Poincelet	ポワンスレ
Poiré	ポワレ
Poiret	ポワレ
Poirier	ポワリエ
Poirot	ポワロ
Poise	ポワズ
Poisson	ポワソン
Poivre	ポワーブル
Pommier	ポミエ
Pompidou	ポンピドゥ
Poncet	ポンセ
Ponette	ポネット
Pouget	プジェ
Poulain	プラン
Poulenard	プールナール
Poulenc	プーランク
Poulet	プーレ
Poupaud	プポー
Poussin	プーサン
Pradon	プラドン
Préaubert	プレオベール
Prébois	プレボワ
Prévert	プレヴェール
Prévost	プレヴォ
Prin	プラン
Printemps	プランタン
Priou	プリウー
Prost	プロスト
Proust	プルスト（プルースト）
Prouvé	プルヴェ
Prudhomme	プリュドム
Pruvot	プリュヴォ
Puech	プエシュ
Puget	ピュジェ
Py	ピー
Queneau	クノー
Quignard	キニャール
Quintard	カンタール
Quoirez	コワレ
Rabasse	ラバス
Rabaud	ラボー
Rabelais	ラブレー
Rabillon	ラビヨン
Rabiqueau	ラビコー
Racine	ラシーヌ
Raffarin	ラファラン
Ramadier	ラマディエ
Rambaud	ランボー
Rameau	ラモー
Ramée	ラメー
Ramoin	ラモワン
Randon	ランドン
Rappeneau	ラプノー
Rattier	ラチエ
Raugel	ロージェル
Rauzier	ロジエ
Raveau	ラヴォー
Ravel	ラヴェル
Raynal	レナル
Raynaud	レノー
Réaumur	レオミュール
Rebel	ルベル
Récamier	ルカミエ
Reclus	ルクリュ
Redon	ルドン
Régis	レジス
Regnard	ルニャール
Regnault	ルニョー
Régnier	レニエ
Rembauville	ランボーヴィル、ランボヴィル
Rémusat	レミュザ
Renan	ルナン
Renard	ルナール
Renaud	ルノー
Renaudat	ルノダ
Renaudineau	ルノディノー
Renault	ルノー
Renié	ルニエ
Renoir	ルノアール、ルノワール
Renou	ルヌー
Renouvier	ルヌヴィエ
Resnais	レネ
Restencourt	レスタンクール
Reubell	ルーベル
Réveillon	レヴェイヨン
Revel	ルヴェル
Reynaud	レノー
Rhodes	ロード
Ribault	リボー
Ribet	リベ
Ribot	リボー
Riboud	リブー
Ricard	リカール
Richard	リシャール
Richelieu	リシュリュー
Richepin	リシュパン
Richet	リシェ
Richez	リシェ
Ricœur	リクール
Ricord	リコール
Ricou	リクー
Riel	リエル
Rigaud	リゴー
Rillieux	リリュー
Rimbaud	ランボー
Ringeissen	ランジェサン
Riot	リオ
Riotte	リオット
Risler	リスレ
Rivarol	リヴァロル
Rivier	リヴィエ
Rivière	リヴィエール
Robert	ロベール
Robien	ロビアン
Robin	ロバン
Rocancourt	ロカンクール
Rocard	ロカール
Rochambeau	ロシャンボー
Roches	ロッシュ
Rode	ロード
Rodet	ロデ
Rodin	ロダン
Roederer	レドレル
Rogé	ロジェ
Roger	ロジェ
Roland	ロラン
Rolland	ロラン
Rolle	ロル
Rollin	ロラン
Ronsard	ロンサール
Ropartz	ロパルツ
Rossel	ロセル、ロッセル
Rothier	ロチエ
Rouard	ルアール
Rouault	ルオー
Roubaix	ルーベ
Rouher	ルエル
Roule	ルール
Rouquier	ルキエ
Roussay	ルセイ
Rousseau	ルソー
Roussel	ルセル、ルーセル
Rousset	ルセ
Rouvier	ルヴィエ
Roux	ルー
Roy	ロワ、ロア
Royer	ロワイエ
Rozier	ロジエ
Ruffier	リュフィエ
Sabatier	サバチエ、サバティエ
Sabouret	サブレ
Sageman	サジュマン
Sagnier	サニエ
Saint-Exupéry	サン＝テグジュペリ
Saint-Georges	サン＝ジョルジュ
Saint-Just	サン＝ジュスト
Saint-Saëns	サン＝サーンス
Saint-Simon	サン＝シモン
Saleilles	サレイユ
Salignac	サリニャック
Sallenave	サルナーヴ
Salvayre	サルヴェール
Samain	サマン
Samuel	サミュエル
Sancan	サンカン
Sandeau	サンドー
Sans	サン
Santerre	サンテール
Saorgin	サオルジャン
Sardou	サルドゥ
Sarraute	サロート
Sarret	サレ
Sartre	サルトル
Satie	サティ
Sauguet	ソーゲ
Saunière	ソニエール
Saussure	ソシュール
Savart	サヴァール
Savatier	サヴァチエ（サヴァティエ）
Savignac	サヴィニャック
Sciamma	シアマ
Séchan	セシャン
Sée	セー
Segond	スゴン
Segonzac	スゴンザック
Séguin	セギャン、セガン
Ségur	セギュール
Séguy	セギー
Seigner	セニエ
Seignobos	セニョボス
Seignolle	セニョル
Semet	スメー
Sénancour	セナンクール
Senneville	セネヴィル
Séraphine	セラフィーヌ
Serfaty	セルファチー
Serpette	セルペット
Serreau	セロー
Serres	セール
Serrière	セリエール
Sérurier	セリュリエ
Sérusier	セリュジエ
Servais	セルヴェ
Servan	セルヴァン
Seurat	スーラ
Sévigné	セヴィニェ
Sibiril	シビリル
Sicot	シコ
Signac	シニャック
Signoret	シニョレ
Silie	シリー
Silvestre	シルヴェストル
Simenon	シムノン
Simon	シモン
Soboul	ソブール
Soller	ソレル
Sonnerat	ソヌラ
Sorbon	ソルボン
Sorel	ソレル
Sorin	ソラン
Soulages	スーラージュ
Soulayrol	スーレイロル
Soulié	スーリエ
Soult	スルト
Soumagnas	スマーニャ
Soupault	スーポー
Souvestre	スヴェストル
Soyer	ソワイエ
Suchet	スシェ
Supervielle	シュペルヴィエル
Suzan	シュザン
Sylvestre	シルヴェストル
Taillon	タイヨン
Taine	テーヌ
Taisnier	テニエ
Talleyrand	タレーラン
Tanguy	タンギー
Tanvier	タンヴィエ
Taquet	タケ
Tardieu	タルデュー
Tassin	タサン
Tellier	テリエ
Terral	テラル
Terrasse	テラッス
Tesmoingt	テモワン
Tessier	テシエ
Testud	テスチュ
Thau	トー
Théaux	テオー
Thenard	テナール
Thiault	チオー
Thibaud	チボー、ティボー
Thibaudet	ティボデ
Thibault	ティボー
Thibaut	チボー、ティボー
Thierry	ティエリー、チエリー
Thiers	ティエール、チエール
Thill	ティル
Thiollier	チオリエ
Thomas	トマ
Thomine	トミーヌ
Thoreau	トロー
Thou	トゥー
Tible	チブル
Tirmont	チルモン、ティルモン
Tirole	ティロル
Titelouze	ティトルーズ
Tixier	ティクシエ
Tostivint	トスチヴァン
Toubon	トゥーボン、ツーボン
Touchard	トゥシャール
Touratier	トゥラチエ
Tournemire	トゥルヌミール
Tournier	トゥルニエ
Tourville	トゥルヴィル
Toussaint	トゥーサン
Touvron	トゥーヴロン
Trantoul	トラントゥール
Trémoulet	トレムレ
Trespeuch	トレスプーシュ
Tribert	トリベール
Tribouillard	トリブイヤール
Trintignant	トランティニャン
Troublé	トルブレ、トゥルブレ
Trouille	トルイユ
Truffaut	トリュフォー
Turenne	チュレンヌ
Urbain	ユルバン
Urfé	ユルフェ
Urville	ユルヴィル
Vachon	ヴァション
Vaguet	ヴァゲ
Vailland	ヴァイヤン
Vaillant	ヴァイヤン、ヴァイヨン
Valadon	ヴァラドン
Valensi	ヴァランシ
Valentin	ヴァランタン
Valéry	ヴァレリー
Vallaud	ヴァロー
Vallée	ヴァレ
Vallès	ヴァレス
Vallier	ヴァリエ
Vallin	ヴァラン
Valois	ヴァロワ
Vandamme	ヴァンダム
Vanot	ヴァノ
Varron	ヴァロン
Vassal	ヴァサル
Vasselin	ヴァセラン
Vassort	ヴァソール
Vaucorbeil	ヴォーコルベイユ
Vaugier	ヴォジエ
Vaultier	ヴォルチエ
Veber	ヴェベール
Védrine	ヴェドリーヌ
Ventard	ヴァンタール
Verdet	ヴェルデ
Verdier	ヴェルディエ
Vergnes	ヴェルニュ
Verlaine	ヴェルレーヌ
Verne	ヴェルヌ
Vernet	ヴェルネ
Vespier	ヴェスピエ
Veyssière	ヴェシエール
Vialatte	ヴィアラット
Viardot	ヴィアルドー
Vidal	ヴィダル
Vidonne	ヴィドンヌ
Vierne	ヴィエルヌ
Vieuille	ヴュイーユ
Vignois	ヴィニョワ
Vigo	ヴィゴ
Villard	ヴィラール
Villechaize	ヴィルシェーズ
Villehardouin	ヴィラルドワン
Villéle	ヴィレール
Villeneuve	ヴィルヌーヴ
Villette	ヴィレット
Villiers	ヴィリエ
Villon	ヴィヨン
Vincent	ヴァンサン
Vionnet	ヴィオネ
Viseur	ヴィズール
Vitry	ヴィトリー
Vivier	ヴィヴィエ
Vix	ヴィクス
Voli	ヴォリ
Volodine	ヴォロディーヌ
Voltaine	ヴォルテーヌ
Vuillard	ヴュイヤール
Vuitton	ヴィトン
Waroquier	ワロキエ
Watteau	ワトー