Aaron	アーロン
Abbey	アビー
Abbington	アビントン
Abbot	アボット
Abbott	アボット
Abel	エイベル
Abercrombie	アバークロンビー
Abernethy	アバネシー
Abington	アビントン
Ace	エース
Acheson	アチソン
Acker	アッカー
Ackerson	アッカーソン、アッカースン
Ackroyd	アクロイド
Acland	アクランド
Acton	アクトン
Adams	アダムズ
Adamson	アダムソン
Adcock	アドコック
Addington	アディントン
Addinsell	アディンセル
Addison	アディソン
Addy	アディ
Adinton	アディントン
Adkins	アドキンズ
Adlam	アドラム
Adrian	エイドリアン
Ager	エイジャー
Agnew	アグニュー
Agutter	アガター
Ahearne	アハーン
Aidan	エイデン
Ailey	エイリー
Aimers	エイマーズ
Ainsworth	エインズワース
Airey	エイリー
Airy	エアリー
Aitken	エイトケン
Albarn	アルバーン
Albright	オルブライト、オールブライト
Alcock	オルコック、オールコック
Alcott	オルコット
Alderson	アルダーソン
Aldington	オールディントン
Aldis	オールディス
Aldiss	オールディス
Aldrich	オールドリッチ
Aldridge	アルドリッジ
Alexander	アレグザンダー（アレクサンダー）
Alford	アルフォード
Algren	オルグレン
Allan	アラン
Allen	アレン
Allenby	アレンビー
Allingham	アリンガム、アリングハム
Allison	アリソン、アリスン
Allport	オールポート
Allston	オールストン
Almond	アーモンド
Ambler	アンブラー
Amery	エーメリー
Ames	エイムズ
Amherst	アマースト
Amis	エイミス
Anderson	アンダーソン、アンダースン
Andrews	アンドルーズ（アンドリュース）
Angell	エンジェル
Ankerson	アンカーソン
Annakin	アナキン
Anthony	アントニー、アンソニー
Anvil	アンヴィル
Appleby	アップルビー
Applegarth	アップルガース
Appleton	アップルトン
Appleyard	アップルヤード
Archer	アーチャー
Archibald	アーチボルド
Aris	アリス
Arkin	アーキン
Arkwright	アークライト
Arliss	アーリス
Armitage	アーミテイジ
Armstrong	アームストロング
Arne	アーン
Arnett	アーネット
Arnold	アーノルド
Arterton	アータートン
Arthur	アーサー
Arthurs	アーサーズ
Ascham	アスカム
Ashbery	アシュベリー、アッシュベリー
Ashburton	アシュバートン
Ashby	アシュビー
Ashcroft	アシュクロフト
Asher	アッシャー
Ashfield	アシュフィールド、アッシュフィールド
Ashley	アシュリー
Ashton	アシュトン
Asquith	アスクウィス（アスキス）
Astley	アストリー
Aston	アストン
Astor	アスター
Atkins	アトキンズ
Atkinson	アトキンソン
Attenborough	アッテンボロー
Attlee	アトリー
Attwell	アットウェル
Attwood	アトウッド
Aubrey	オーブリー
Auden	オーデン
Audsley	オーズリー
Audubon	オーデュボン
Austin	オースティン
Avallone	アヴァロン
Aveling	エイヴリング
Avery	エイヴァリー、エーヴリー
Avory	エイヴォリー
Awdry	オードリー
Aynsley	エインズリー（エインズレイ）
Ayrton	エアトン
Babbage	バベッジ
Babbington	バビントン
Backley	バックリー
Bacon	ベーコン
Bagehot	バジョット
Bagley	バグリー
Bagwell	バグウェル
Bailey	ベイリー
Baily	ベイリー
Bain	ベイン
Baines	ベインズ
Baird	ベアード
Baker	ベイカー
Balbirnie	バルバーニー
Baldwin	ボールドウィン
Bale	ベイル
Balfe	バルフ
Balfour	バルフォア
Ball	ボール
Ballard	バラード
Balliol	ベイリアル
Bamber	バンバー
Banes	ベインズ
Banfield	バンフィールド
Bankes	バンクス
Banks	バンクス
Bannerman	バナマン
Bannister	バニスター
Bantock	バントック
Barbour	バーバー
Barclay	バークレイ
Baring	ベアリング
Barker	バーカー
Barks	バークス
Barlow	バーロウ
Barlowe	バーロウ
Barnard	バーナード
Barnes	バーンズ
Barnett	バーネット
Barr	バー
Barraclough	バラクロフ
Barrett	バレット
Barrie	バリー
Barrington	バリントン
Barron	バロン
Barry	バリー
Barth	バース
Bartlett	バートレット
Barton	バートン
Baskerville	バスカヴィル
Bassett	バセット
Batchelor	バチェラー
Bates	ベイツ
Bateson	ベイトソン
Battle	バトル
Bax	バックス
Baxter	バクスター、バックスター
Bayly	ベイリー
Beaconsfield	ビーコンズフィールド
Beadon	ビードン
Beale	ビール
Beamont	ビーモント
Bean	ビーン
Beanland	ビーンランド
Beardsley	ベアーズリー、ビアズリー
Beaton	ビートン
Beattie	ビーティー
Beatty	ビーティー
Beaumont	ボーモント
Beck	ベック
Becket	ベケット
Beckett	ベケット
Beckford	ベックフォード
Beckham	ベッカム
Beckles	ベックルズ
Beckley	ベックリー
Beckwith	ベックウィズ
Beddoe	ベドー
Bedford	ベッドフォード
Beecham	ビーチャム
Belew	ブリュー
Bell	ベル
Bellamy	ベラミー
Bellnap	ベルナップ
Benfield	ベンフィールド
Benjamin	ベンジャミン
Bennett	ベネット
Bennington	ベニントン
Benson	ベンソン
Bent	ベント
Bentham	ベンサム
Bentley	ベントリー
Beresford	ベレスフォード
Bergin	バーギン
Bergson	バーグソン
Berkeley	バークリー
Berkley	バークリー
Berners	バーナーズ
Berry	ベリー
Berufort	ボーフォート
Besant	ベサント
Bessemer	ベッセマー
Best	ベスト
Bettany	ベッタニー、ベタニー
Bevan	ベヴァン
Beverley	ビヴァリー
Beverly	ビヴァリー
Bevin	ベヴィン
Beynon	ベイノン
Bigod	バイゴッド
Billingham	ビリンガム
Bimiller	バイミラー
Bingham	ビンガム
Bingley	ビングリー
Bird	バード
Birkin	バーキン
Birley	バーリー
Birtwistle	バートウィッスル
Bishop	ビショップ
Bixby	ビクスビー
Black	ブラック
Blackburn	ブラックバーン
Blackman	ブラックマン
Blackmore	ブラックモア
Blackstone	ブラックストン
Blackwell	ブラックウェル
Blackwood	ブラックウッド
Blagden	ブラグデン
Blain	ブレイン
Blair	ブレア
Blake	ブレイク
Blakeley	ブレイクリー、ブレークリー
Blaze	ブレイズ
Blethyn	ブレッシン
Bliss	ブリス
Blow	ブロウ
Blythe	ブライス
Blyther	ブライサー
Blyton	ブライトン
Board	ボード
Bogard	ボガード
Bohun	ブーン
Boldwin	ボールドウィン
Boleyne	ブーリン
Bolger	ボルジャー
Bollan	ボラン
Bolton	ボルトン
Bonar	ボナー
Bond	ボンド
Bonham	ボーナム
Bonnet	ボネット
Boore	ブーア
Booth	ブース
Borman	ボーマン
Borrow	ボロー、ボロウ
Bott	ボット
Boucher	バウチャー
Boughton	ボートン
Boult	ボールト
Bound	バウンド
Bourne	ボーン
Bousfield	バウスフィールド
Bowe	ボウ
Bowen	ボウエン、ボーウェン
Bower	バウアー
Bowles	ボウルズ
Bowman	ボウマン
Bowyer	ボウヤー
Boxer	ボクサー
Boyce	ボイス
Boyd	ボイド
Boydell	ボイデル
Boyett	ボイエット
Boyle	ボイル
Brackley	ブラックリー
Bradburn	ブラッドバーン
Bradford	ブラッドフォード
Bradlaugh	ブラッドロー
Bradley	ブラッドリー
Bradshaw	ブラッドショー
Bradwell	ブラドル
Brady	ブレイディ
Bragg	ブラッグ
Braham	ブレアム
Brain	ブレイン
Branagh	ブラナー
Brandner	ブランドナー
Branson	ブランソン
Braose	ブロウズ
Braun	ブローン
Brawn	ブロウン、ブローン
Brayham	ブレイアム
Brazier	ブレイジャー
Brealey	ブレーリー
Bream	ブリーム
Breen	ブリーン
Breese	ブリース
Breeze	ブリーズ
Brembre	ブレンバ
Brenan	ブレナン
Brennan	ブレナン
Brett	ブレット
Brewster	ブルースター
Brice	ブライス
Brick	ブリック
Bridge	ブリッジ
Bridges	ブリッジズ
Briers	ブライアーズ
Brightman	ブライトマン
Brighton	ブライトン
Brightwell	ブライトウェル
Brindle	ブリンドル
Brinkley	ブリンクリー
Brinton	ブリントン
Bristol	ブリストル
Britten	ブリテン
Broadbent	ブロードベント
Broadhurst	ブロードハースト
Brock	ブロック
Brocklebank	ブロックルバンク
Broderick	ブロデリック
Brodrick	ブロドリック
Bromley	ブロムリー
Bronson	ブロンソン
Brook	ブルック
Brooke	ブルック
Brooks	ブルックス
Brophy	ブロフィー
Broughton	ブロウトン
Brown	ブラウン
Browne	ブラウン
Browning	ブラウニング
Bruce	ブルース
Bruford	ブルフォード（ブラッフォード）
Brunning	ブラニング
Bruton	ブルートン
Bryant	ブライアント
Bryce	ブライス
Buchanan	ブキャナン
Buckingham	バッキンガム
Buckland	バックランド
Buckle	バックル
Buckley	バックリー
Budd	バッド
Bugg	バッグ
Buggy	バギー
Bull	ブル
Bullock	ブロック
Bunbury	バンバリー
Bunch	バンチ
Burden	バーデン
Burgess	バージェス
Burke	バーク
Burkitt	バーキット
Burleigh	バーレイ
Burnett	バーネット
Burns	バーンズ
Burr	バー
Burrell	バレル
Burris	バーリス
Burroughs	バロウズ、バローズ
Burrows	バロウズ、バローズ
Burt	バート
Burton	バートン
Busby	バズビー
Bush	バッシュ
Bussell	バッセル
Butler	バトラー
Butterfield	バターフィールド
Byatt	バイアット
Byrd	バード
Byrne	バーン
Byron	バイロン
Cabot	キャボット
Cadbury	キャドバリー、カドバリー
Cade	ケード
Cadogan	カドガン
Cage	ケイジ、ケージ
Cahill	ケイヒル
Caine	ケイン
Caird	ケアード
Calder	カルダー
Caldwell	コールドウェル
Callaghan	キャラハン
Callow	キャロウ
Calvert	カルヴァート
Cambell	キャンベル
Camden	カムデン、キャムデン
Cameron	キャメロン、カメロン
Campbell	キャンベル
Campian	キャンピアン
Campion	キャンピオン
Camps	キャンプス
Cannadine	キャナダイン
Canning	カニング
Card	カード
Cardiff	カーディフ
Carey	ケアリー、キャリー
Carleton	カールトン
Carlin	カーリン
Carlisle	カーライル
Carlton	カールトン
Carlyle	カーライル
Carnall	カーナル
Carnegie	カーネギー
Carr	カー
Carrack	カラック、キャラック
Carrington	キャリントン
Carrol	キャロル、カロル
Carroll	キャロル
Carson	カーソン
Carter	カーター
Cartlidge	カートリッジ
Cartpenter	カーペンター
Cartwright	カートライト
Carvel	カーヴェル
Carvell	カーヴェル
Cary	ケアリー
Case	ケイス、ケース
Casey	ケイシー
Cashman	キャッシュマン
Cassells	カッセルズ
Cattermole	キャターモール
Cattrall	カトラル
Cavendish	キャヴェンディッシュ
Cavill	カヴィル
Caxton	キャクストン
Cayford	ケイフォード
Cayley	ケーリー
Cecil	セシル
Chad	チャド
Challis	チャリス
Chamberlain	チェンバレン
Chambers	チェンバーズ
Chandler	チャンドラー
Chapman	チャップマン
Charlton	チャールトン
Charnley	チャーンリー
Chatwin	チャットウィン
Chaucer	チョーサー
Chauncey	チャンシー
Cheers	チアーズ
Chenoweth	チェノウェス
Cheshire	チェシャー
Chesterton	チェスタートン
Chichester	チチェスター
Child	チャイルド
Childs	チャイルズ
Chipchase	チップチェイス
Christie	クリスティ
Church	チャーチ
Churchill	チャーチル
Citrine	シトリン
Clackson	クラックソン
Clapton	クラプトン
Clark	クラーク
Clarke	クラーク
Clay	クレイ
Clayton	クレイトン
Cleaves	クリーヴズ
Cleese	クリーズ
Clegg	クレッグ
Cleland	クレランド
Cleobury	クリーバリー
Clerihew	クレリヒュー
Cleveland	クリーヴランド
Cleverley	クレヴァリー
Clifford	クリフォード
Clifton	クリフトン
Clinton	クリントン
Clive	クライヴ
Close	クローズ
Clough	クロフ
Coates	コーツ
Cobbett	コベット
Cockburn	コバーン、コウバーン
Cocker	コッカー
Codd	コッド
Coen	コーエン
Coffey	コフィ
Colbourne	コルボーン
Cole	コール
Coleman	コールマン
Coleridge	コールリッジ
Coles	コールズ
Colet	コレット
Colkett	コルケット
Colledge	カレッジ
Collett	コレット
Colley	コリー
Collier	コリアー
Collins	コリンズ
Collinson	コリンソン
Colman	コールマン
Colquhoun	コフーン
Colyer	コリアー
Comerford	カマーフォード
Comyn	カミン
Conaghan	コナハン
Condren	コンドレン
Coney	コニー
Conlon	コンロン
Connelly	コネリー
Connery	コネリー
Connick	コニック
Connolly	コノリー
Connor	コナー
Conquest	コンクエスト
Conrad	コンラッド
Conroy	コンロイ
Considine	コンシダイン
Coogan	クーガン
Cook	クック
Cooke	クック
Coomes	クームズ
Cooper	クーパー
Cope	コープ
Copland	コープランド
Coppard	コッパード
Copperfield	コパーフィールド
Corbett	コーベット
Cork	コーク
Cormack	コーマック
Cornell	コーネル
Cornes	コーンズ
Cornish	コーニッシュ
Cornwell	コーンウェル
Corrie	コーリー
Corrigan	コリガン
Coughlin	コフリン
Coulfield	コールフィールド
Coulson	クールソン
Coulthard	コルトハード、クルサード
Court	コート
Courtenay	コートネイ
Cousins	カズンズ
Coverdale	カヴァデイル、カヴァーディル
Covington	コヴィントン
Cowan	カウワン
Coward	カワード
Cowen	カウエン、コーウェン
Cowley	カウリー
Cowling	カウリング
Cowper	カウパー
Cox	コックス
Coxon	コクソン
Craig	クレイグ
Craine	クレイン
Cram	クラム
Crammer	クランマー
Crane	クレイン
Craven	クレイヴン
Crawford	クロフォード
Creagh	クレイ
Creighton	クライトン
Crenshaw	クレンショー
Crewe	クルー
Crewes	クルーズ
Cripps	クリップス
Crocker	クロッカー
Crockford	クロックフォード
Croft	クロフト
Crofts	クロフツ
Croke	クローク
Crompton	クロンプトン
Cromwell	クロムウェル
Cronnelly	クロネリー
Crook	クルック
Crosbie	クロズビー
Crossley	クロスリー
Crowdey	クラウディー
Crowe	クロウ
Crowley	クロウリー
Crowther	クラウザー
Croydon	クロイドン
Cruikshank	クルックシャンク
Crumb	クラム
Crystal	クリスタル
Cullen	カレン
Cumberbatch	カンバーバッチ
Cunningham	カニンガム、カニングハム
Currie	カーリー
Curry	カリー
Curtis	カーティス
Curzon	カーゾン
Cushing	カッシング
Cuthbertson	カスバートソン
Cutter	カッター
d'Arcy	ダーシー
Daines	デインズ
Daisley	ディズリー
Dale	デイル
Daley	デイリー
Dallimore	ダリモア
Dalton	ダルトン
Daltrey	ダルトリー
Damon	デイモン、デーモン
Dane	デイン
Danes	デーンズ
Daniel	ダニエル
Danvers	ダンヴァーズ
Darling	ダーリング
Darwin	ダーウィン
Dashwood	ダッシュウッド
Davenport	ダヴェンポート
Davidson	デヴィッドソン
Davies	デイヴィーズ
Davis	デイヴィス
Davison	デイヴィソン
Davy	デイヴィー
Dawson	ドーソン
Day	デイ
Deacon	ディーコン
Deakin	ディーキン
Deamer	ディーマー
Dean	ディーン
Decker	デッカー
Deighton	デイトン
Dekker	デッカー
Delaney	デレイニー、ダレイニー
Delany	デラニー
Demery	デミリー
Dempsey	デンプシー
Dench	デンチ
Denham	デナム
Dennett	デネット
Dennis	デニス
Denny	デニー
Derby	ダービー
Derbyshire	ダービーシャー
Desmond	デズモンド
Devlin	デヴリン
Devonish	デヴォニッシュ
Dew	デュー
Dewar	デュアー
Dewey	デューイ
Dexter	デクスター
Dickens	ディケンズ
Dickinson	ディッキンソン
Dickson	ディクソン
Dilke	ディルク
Dill	ディル
Dillon	ディロン
Dimbleby	ディンブルビー
Dineley	ダインリー
Dingley	ディングリー
Dirac	ディラック
Diskin	ディスキン
Disley	ディズリー
Dixon	ディクソン
Dobson	ドブソン
Dockrill	ドクリル、ドックリル
Dodgson	ドッジソン、ドジソン
Doherty	ドハティ、ドーハティ
Dolan	ドラン
Donaghy	ドナフィー
Donaldson	ドナルドソン
Donne	ダン
Donnellon	ドネロン
Donnelly	ドネリー
Donovan	ドノヴァン
Douglas	ダグラス
Dowdall	ダウダル
Dowdeswell	ダウズウェル
Dowding	ダウディング
Dowell	ダウエル
Dowland	ダウランド
Dowling	ダウリング
Downer	ダウナー
Downes	ダウンズ
Downing	ダウニング
Dowson	ダウソン
Doyle	ドイル
Drabble	ドラブル
Drake	ドレイク、ドレーク
Dransfield	ドランスフィールド
Draper	ドレイパー
Drewett	ドリューウェット
Driscoll	ドリスコル
Driver	ドライヴァー
Druitt	ドゥルイット
Drummond	ドラモンド
Duckworth	ダックワース
Dudley	ダドリー
Duff	ダフ
Duffield	ダフィールド
Duffy	ダフィ
Dumville	ダンヴィル
Dunbar	ダンバー
Duncan	ダンカン
Dunford	ダンフォード
Dunhill	ダンヒル
Dunleavy	ダンリーヴィー
Dunlop	ダンロップ
Dunn	ダン
Dunning	ダニング
Dunstable	ダンスタブル
Durrell	ダレル
Dyer	ダイアー
Dyson	ダイソン
Eagle	イーグル
Eagleton	イーグルトン
Ealdred	エアルドレッド
Eames	イームズ
Earhart	エアハート
Easdale	イーズデイル、イースデイル
Easterbrook	イースターブルック
Easton	イーストン
Eaton	イートン
Eccles	エックルズ
Eccleston	エクルストン
Eckert	エッカート
Eddington	エディントン
Eddison	エディスン
Eddowes	エドウズ
Eden	イーデン
Edge	エッジ
Edgeworth	エッジワース
Edison	エディソン
Edkins	エドキンズ
Edmonds	エドモンズ
Edmundson	エドマンドソン
Edney	エドニー
Edwards	エドワーズ
Edwin	エドウィン
Effinger	エフィンジャー
Egan	イーガン
Eggar	エッガー
Eggleston	エグルストン
Eggleton	エグルトン
Eklund	エクランド
Eldon	エルドン
Eldred	エルドレッド
Eley	イーリー
Elgar	エルガー
Elgin	エルギン
Eliot	エリオット
Elkin	エルキン
Ellington	エリントン
Elliot	エリオット
Elliott	エリオット
Ellis	エリス
Ellison	エリソン
Ellsberg	エルズバーグ
Ellwood	エルウッド
Elman	エルマン
Elmes	エルムズ
Elphinstone	エルフィンストーン
Elton	エルトン
Elwes	エルウィズ
Ely	イーリイ
Embrey	エンブリー
Embury	エンベリー
Emerson	エマーソン
Emery	エメリー
Emmet	エメット
Enfield	エンフィールド
England	イングランド
Englefield	エングルフィールド
English	イングリッシュ
Ennis	エニス
Entwistle	エントウィッスル
Erikson	エリクソン
Erskine	アースキン
Esmond	エズモンド
Etchison	エチスン
Etheridge	エサリッジ
Etherington	エザリントン
Evans	エヴァンズ
Evarts	エヴァーツ
Evatt	エヴァット
Eveleigh	エヴェリー
Everest	エヴェレスト
Everett	エヴァレット
Ewing	ユーイング
Fairchild	フェアチャイルド
Fairclough	フェアクロフ
Fairfield	フェアフィールド
Falconer	ファルコナー
Fallon	ファロン
Faraday	ファラデー
Farar	ファラー
Farber	ファーバー
Farley	ファーリー
Farnaby	ファーナビー
Farnham	ファーナム
Farnon	ファーノン
Farquhar	ファーカー
Farrell	ファレル
Farrington	ファリントン
Faulcon	フォールコン
Fayrfax	フェアファクス
Fearon	フィアロン
Featherstonehaugh	ファンショー
Fee	フィー
Felton	フェルトン
Fennelly	フェネリー
Ferguson	ファーガソン
Ferrar	フェラー
Ferris	フェリス
Ferry	フェリー
Fetherston	フェザーストン
Field	フィールド
Fielding	フィールディング
Fiennes	ファインズ
Figgis	フィギス
Finch	フィンチ
Findlay	フィンドレイ
Finlay	フィンリー
Finley	フィンリー
Firestone	ファイアストン
Firobisher	フィーロビッシャー
Firth	ファース
Fishburne	フィッシュバーン
Fisher	フィッシャー
FitzClarence	フィッツクラレンス
FitzGerald	フィッツジェラルド
FitzMaurice	フィッツモーリス
FitzPatrick	フィッツパトリック
FitzRoy	フィッツロイ
FitzSimmons	フィッツシモンズ
FitzSimons	フィッツシモンズ
Flaherty	フラハティ
Flamsteed	フラムスティード
Flecker	フレッカー
Fleetwood	フリートウッド
Fleming	フレミング
Flemyng	フレミング
Fletcher	フレッチャー
Flint	フリント
Flockhart	フロックハート
Florence	フロレンス、フローレンス
Florey	フローリー
Follett	フォレット
Foot	フット
Forbes	フォーブズ
Ford	フォード
Forester	フォレスター
Forgus	フォーガス
Forster	フォースター
Forsyth	フォーサイス
Fortescue	フォーテスキュー
Fortune	フォーチュン
Foster	フォスター
Foulds	フォウルズ、フォールズ
Fowler	ファウラー
Fowles	ファウルズ
Fox	フォックス
Frampton	フランプトン
Francis	フランシス
Franklin	フランクリン
Fraser	フレーザー
Freeman	フリーマン
Freemantle	フリーマントル
Friday	フライデイ
Friel	フリエル
Fripp	フリップ
Frost	フロスト
Froude	フルード
Fry	フライ
Fugler	フーグラー
Fuller	フラー
Fullerton	フラトン
Furnivall	ファーニヴァル
Gage	ゲージ
Gahan	ガーン
Gainsborough	ゲーンズボロ
Gaitskell	ゲートスケル
Galbraith	ギャルブレイス、ガルブレイス
Gale	ゲイル
Gallagher	ギャラガー、ガラハー
Galloway	ギャロウェイ
Galsworthy	ゴールズワージー
Galton	ゴールトン
Galvin	ギャルヴィン
Galway	ゴールウェイ
Garber	ガーバー
Gardener	ガードナー
Gardiner	ガーディナー
Gardner	ガードナー
Garfield	ガーフィールド
Garland	ガーランド
Garnet	ガーネット
Garnett	ガーネット
Garrett	ギャレット
Garson	ガースン
Gascoigne	ガスコイン
Gascoyne	ガスコイン
Gaster	ガスター
Gatiss	ゲイティス
Gaveston	ギャヴィストン
Gawley	ガウリー、ギャウリー
Gay	ゲイ
Gayson	ゲイソン
Gazzard	ガザード
Gee	ジー
George	ジョージ
Geraghty	ゲラティ
German	ジャーマン
Gettens	ゲッテンズ
Gibbins	ギビンズ
Gibbon	ギボン
Gibbons	ギボンズ
Gibbs	ギブス
Gibney	ギブニー
Gibson	ギブソン
Giddens	ギデンズ
Gielgud	ギルグッド、ギールグッド
Giles	ジャイルズ
Gillan	ギラン
Gillett	ギレット
Gillings	ギリングズ
Gilmartin	ギルマーティン
Gilmore	ギルモア
Gilmour	ギルモア
Gilthorpe	ギルソープ
Gimson	ギムソン
Girtin	ガーティン
Gissing	ギッシング
Gladstone	グラッドストン
Glasspool	グラスプール
Gleeson	グリーソン
Glen	グレン
Glover	グローヴァー
Goddard	ゴダード
Godolphin	ゴドルフィン
Godrich	ゴッドリッチ
Godwin	ゴドウィン
Golbourn	ゴルボーン
Goldberg	ゴールドバーグ
Golding	ゴールディング
Goldsmith	ゴールドスミス
Goldsworthy	ゴールズワージー
Golledge	ゴレッジ
Gooch	グーチ
Goodall	グッドオール
Goode	グッド
Goodfellow	グッドフェロー
Goodgame	グッドゲーム
Goodwin	グッドウィン
Gordon	ゴードン
Gore	ゴア
Gorham	ゴーラム
Gorry	ゴーリー
Gorton	ゴートン
Gosling	ゴスリング
Goss	ゴス
Gough	ガフ
Goulding	ゴールディング
Gower	ガワー、ガウアー
Grady	グレイディ
Grafton	グラフトン
Graham	グレアム、グレイアム
Grant	グラント
Granville	グランヴィル
Graves	グレイヴズ
Gray	グレイ
Green	グリーン
Greenaway	グリーナウェイ
Greenbury	グリーンバリー
Greene	グリーン
Greenfield	グリーンフィールド
Greenhalgh	グリーンハルシュ、グリーンハルジュ
Greenhough	グリーンハウ
Greening	グリーニング
Greenwood	グリーンウッド
Gregory	グレゴリー
Gregson	グレグソン
Grenfell	グレンフェル
Grennell	グレネル
Grenville	グレンヴィル
Gresham	グレシャム
Grewcock	グルーコック
Grey	グレイ、グレー
Grierson	グリアーソン
Griffin	グリフィン
Griffith	グリフィス
Griffiths	グリフィス
Grindey	グラインディー
Grint	グリント
Grocyn	グロシン
Grosseteste	グローステスト
Grove	グローヴ
Groves	グローヴズ
Gruber	グルーバー
Guest	ゲスト
Guiness	ギネス
Guinness	ギネス
Guises	ギーズ
Gulbenkian	グルベンキアン
Gunn	ガン
Gunnell	ガネル
Gunter	ガンター
Guthrie	ガスリー
Gutteridge	ガターリッジ
Guyler	ガイラー
Gwatkin	グワトキン
Gwilt	グウィルト
Gwyn	グウィン
Gyle	ガイル
Hack	ハック
Hacker	ハッカー
Hackman	ハックマン
Haddock	ハドック
Haddon	ハッドン
Hadley	ハドリー
Haggard	ハガード
Hailey	ヘイリー
Haines	ヘインズ
Hainsby	ヘインズビー
Haldane	ホールデン、ホールデイン
Hale	ヘイル
Hales	ヘールズ
Haley	ヘイリー
Halford	ハルフォード
Hall	ホール
Halley	ハリー
Halliday	ハリディ
Hallows	ハロウズ、ハローズ
Halmshaw	ハルムショー
Halsall	ハルソール、ホルソール
Hambling	ハンブリング
Hamer	ヘイマー
Hamerton	ハマートン
Hamilton	ハミルトン
Hammerton	ハマートン
Hammond	ハモンド
Hampson	ハンプソン
Hampton	ハンプトン
Hancock	ハンコック
Hand	ハンド
Hanks	ハンクス
Hanretty	ヘンレッティ
Hanson	ハンソン
Hansson	ハンセン
Harcourt	ハーコート
Hardcastle	ハードキャッスル
Harding	ハーディング
Hardstaff	ハードスタッフ
Hardy	ハーディ、ハーディー
Hare	ヘア
Hargin	ハーギン
Hargreaves	ハーグリーヴズ
Harington	ハリントン
Harlow	ハーロウ、ハーロー
Harmsworth	ハームズワース
Harness	ハーネス
Harper	ハーパー
Harries	ハリーズ
Harrington	ハリントン
Harris	ハリス
Harrison	ハリスン、ハリソン
Hart	ハート
Hartfield	ハートフィールド
Hartley	ハートリー
Hartnett	ハートネット
Hartshorne	ハーツホーン
Harvey	ハーヴィー（ハーヴェイ）
Haskell	ハスケル
Haslam	ハズラム
Hasluck	ハズラック
Hastings	ヘイスティングズ
Haswell	ハズウェル
Hatcher	ハッチャー
Hathaway	ハサウェイ
Hatson	ハストン
Hatton	ハットン
Hauksbee	ホークスビー
Haviland	ハヴィランド
Hawken	ホーケン
Hawkey	ホーキー
Hawkins	ホーキンズ
Hawkyard	ホークヤード
Hawley	ホーリー
Haworth	ハワース
Hawthorne	ホーソーン
Hawtrey	ホートリー
Hay	ヘイ
Hayden	ヘイデン
Hayes	ヘイズ
Haynes	ヘインズ
Hays	ヘイズ
Haythornthwaite	ヘイソーンスウェイト
Hayward	ヘイワード
Haywood	ヘイウッド
Hazeldine	ヘーゼルダイン
Hazell	ヘイゼル、ハイゼル
Headley	ヘッドリー
Healy	ヒーリー
Heartfield	ハートフィールド
Heasman	ヒーズマン
Heath	ヒース
Heathcoat	ヒースコート
Heather	ヘザー
Heatley	ヒートリー
Heaviside	ヘヴィサイド
Hegarty	ヘガティ
Helson	ヘルソン
Henderson	ヘンダーソン
Henfrey	ヘンフリー
Henman	ヘンマン
Hennig	ヘニング
Henrit	ヘンリット
Henry	ヘンリー
Henryson	ヘンリソン
Henshall	ヘンシャル
Hensley	ヘンズリー
Henwood	ヘンウッド
Hepburn	ヘップバーン、ヘプバーン
Herbert	ハーバート
Herriot	ヘリオット
Herschel	ハーシェル
Hervey	ハーヴィー
Hession	ヘッション
Heston	ヘストン
Hetherington	ヘザリントン
Hewitt	ヒューイット
Heyes	ヘイズ
Heywood	ヘイウッド
Hibbert	ヒバート
Hickey	ヒッキー
Hicks	ヒックス
Hicky	ヒッキー
Higginbotham	ヒギンボトム
Higgins	ヒギンズ
Hill	ヒル
Hilton	ヒルトン
Hinchcliffe	ヒンチクリフ
Hinckley	ヒンクリー
Hinkley	ヒンクリー
Hinshelwood	ヒンシェルウッド
Hinsley	ヒンズリー
Hiscock	ヒスコック
Hitchcock	ヒッチコック
Hitchens	ヒッチンズ
Hitchon	ヒチョン
Hoare	ホア、ホー
Hodge	ホッジ
Hodges	ホッジズ
Hodgkinson	ホジキンソン
Hoffman	ホフマン
Hogan	ホーガン
Hogarth	ホガース
Holbein	ホルバイン
Holborne	ホルボーン
Holbrooke	ホルブルック
Holden	ホールデン
Holdsworth	ホールズワース
Holles	ホーリス
Hollingworth	ホリングワース
Holloway	ホロウェイ
Holmes	ホームズ
Holst	ホルスト
Holyland	ホーリーランド
Home	ヒューム
Honeyball	ハニーボール
Hooker	フーカー
Hooper	フーパー
Hopkins	ホプキンズ
Hopkinson	ホプキンソン
Hopper	ホッパー
Horgan	ホーガン
Hornby	ホーンビー
Hornsby	ホーンズビー
Horsewood	ホースウッド
Horwood	ホーウッド
Hoskins	ホスキンズ
Houghton	ハウトン
Household	ハウスホールド
Housman	ハウスマン
Houston	ヒューストン
Howard	ハワード
Howe	ハウ
Howell	ハウエル
Howells	ハウエルズ
Howitt	ハウイット
Hoyle	ホイル
Hubbard	ハバード
Huddleston	ハドルストン
Hudson	ハドソン、ハドスン
Huffington	ハフィントン
Hughes	ヒューズ
Hull	ハル
Hulme	ヒューム
Hume	ヒューム
Humfrey	ハンフリー
Humphreys	ハンフリーズ
Humphries	ハンフリーズ
Humphry	ハンフリー
Hungate	ハンゲイト
Hunt	ハント
Hunte	ハント
Hunter	ハンター
Huntington	ハンティントン
Hurd	ハード
Hurley	ハーリー
Hustler	ハスラー
Hutchings	ハッチングズ
Hutchinson	ハッチンソン
Hutson	ハトソン、ハトスン
Huttlestone	ハトルストーン
Hutton	ハットン
Huxham	ハクサム
Huxley	ハクスリー
Hyatt	ハイアット
Hyde	ハイド
Hydon	ハイドン
Hyland	ハイランド
Hyndman	ハインドマン
Idle	アイドル
Ince	インス
Inge	イング
Ingleby	イングルビー
Inglis	イングリス
Ingram	イングラム
Inman	インマン
Inns	インズ
Ireland	アイアランド
Ireton	アイアトン
Irons	アイアンズ
Irvine	アーヴィン、アーヴァイン
Irving	アーヴィング
Isaacs	アイザックス
Isherwood	イシャーウッド
Ives	アイヴズ
Izzard	イザード
Jackman	ジャックマン
Jackson	ジャクソン
Jacobs	ジェイコブズ
Jagger	ジャガー
James	ジェームズ
Jamieson	ジェイミソン
Jarman	ジャーマン
Jarvis	ジャービス
Jeffers	ジェファーズ
Jefferson	ジェファーソン
Jeffrey	ジェフリー
Jeffreys	ジェフリーズ
Jekyll	ジーキル（ジキル）
Jenkins	ジェンキンズ
Jenkinson	ジェンキンソン
Jenks	ジェンクス
Jenner	ジェナー
Jibson	ジブソン
John	ジョン
Johns	ジョーンズ
Johnson	ジョンソン
Johnston	ジョンストン
Johnstone	ジョンストーン
Jones	ジョーンズ
Jonson	ジョンソン
Joplin	ジョプリン
Jordan	ジョーダン
Joseph	ジョーセフ
Joule	ジュール
Joyce	ジョイス
Judge	ジャッジ
Kavanagh	カヴァナー
Kay	ケイ
Kean	キーン
Kearney	ケアニー、カーニー
Kearns	カーンズ
Keats	キーツ
Keeley	キーリー
Keen	キーン
Keenan	キーナン
Keighley	キースリー
Kellegher	ケラハー
Kellett	ケレット
Kelly	ケリー
Kemble	ケンブル
Kemp	ケンプ
Kendall	ケンドール
Kendrick	ケンドリック
Kenna	ケンナ、ケナ
Kennedy	ケネディ
Kennett	ケネット
Kensit	ケンジット
Kent	ケント
Kerney	カーニー
Kerr	カー
Kersh	カーシュ
Kershaw	カーショー
Keynes	ケインズ
Keys	キーズ
Kidman	キッドマン
Kilner	キルナー
Kimberley	キンバリー
Kimbery	キンバリー
Kincaid	キンケイド
King	キング
Kingscote	キングスコート
Kingsley	キングスリー
Kingston	キングストン
Kington	キングトン
Kipling	キプリング
Kirk	カーク
Kirkby	カービー
Kirkland	カークランド
Kirkman	カークマン
Kissack	キサック
Kissinger	キッシンジャー
Kitchen	キッチン
Kneen	ニーン
Knight	ナイト
Knightley	ナイトリー（ナイトレイ）
Knolles	ノールズ
Knott	ノット
Knowland	ノーランド
Knowles	ノールズ
Knox	ノックス
Kwouk	クウォーク
Laine	レイン
Laing	レイン
Laird	レアード
Lake	レイク
Lamb	ラム
Lambert	ランバート
Lance	ランス
Lanchester	ランチェスター
Landon	ランドン
Lane	レイン
Lanfranc	ランフランク
Langdon	ラングドン
Langford	ラングフォード
Langridge	ラングリッジ
Langshaw	ラングショー
Langton	ラングトン
Lannaman	ラナマン
Lansbury	ランズベリー
Lansdowne	ランズダウン
Lappin	ラッピン
Larkins	ラーキンズ
Larner	ラーナー
Lascelles	ラッセルズ
Latimer	ラティマー
Laughton	ロートン
Laurenson	ローレンソン
Law	ロウ、ロー
Lawes	ローズ、ロウズ
Lawrence	ローレンス
Lawson	ローソン
Lawton	ロートン
Layard	レヤード
Leach	リーチ
Leacock	リーコック
Leahy	レイヒー
Leakey	リーキー
Lean	リーン
Lear	リア
Leary	リーリー、リアリー
Leavis	リーヴィス
Lecky	レッキー
Lee	リー
Leek	リーク
Legge	レッグ
Leigh	リー
Leighton	レイトン
Leith	リース
Leland	リーランド
Lemmon	レモン
Lennon	レノン
Lerwill	ラーウィル
Leslie	レスリー、レズリー
Lessing	レッシング
Lester	レスター
Levin	レヴィン
Levine	レヴァイン
Levingston	リヴィングストン
Levins	レヴィンズ
Lewis	ルイス
Leyland	レイランド
Leyton	レイトン
Lick	リック
Liddell	リデル
Lightfoot	ライトフット
Lilburne	リルバーン
Lilienthal	リリエンソール
Lillie	リリー
Lillywhite	リリーホワイト
Lily	リリー
Lilye	リリー
Linacre	リナカー
Lindbergh	リンドバーグ
Lindgren	リンドグレーン
Lindley	リンドリー
Lindsay	リンジー
Lindsey	リンジー
Linehan	リネハン
Linton	リントン
Lippincott	リッピンコット
Lipscomb	リプスコム
Lipset	リプセット
Lipson	リプソン
Lipton	リプトン
Lister	リスター
Littler	リトラー
Littleton	リトルトン
Livermore	リヴァーモア
Livingston	リヴィングストン
Livingstone	リヴィングストン
Llewellyn	ルウェリン
Lloyd	ロイド
Lockhart	ロックハート
Logan	ローガン
London	ロンドン
Lonergan	ロナガン
Long	ロング
Longfellow	ロングフェロー
Longhurst	ロングハースト
Lonsdale	ロンズデール
Lord	ロード
Lott	ロット
Love	ラヴ
Lovecraft	ラヴクラフト
Lowe	ロウ
Lowell	ローウェル
Loweth	ローウェス
Lucas	ルーカス
Luce	ルース
Lucraft	ルークラフト
Lugard	ルガード
Lumley	ラムリー
Lydgate	リドゲート
Lyly	リリー
Lynch	リンチ
Lynd	リンド
Lynde	リンド
Lynton	リントン
Lyons	ライアンズ、ライオンズ
Lythgoe	リスゴー
Lyttelton	リトルトン
Lytton	リットン
Mabe	メイブ
MacAlpine	マカパイン
MacArthur	マカーサー、マッカーサー
Macaulay	マコーレー
Macauley	マコーリー
MacBride	マクブライド
MacDonald	マクドナルド
MacDonnel	マクドネル
MacFarlane	マクファーレン
MacFarren	マクファーレン
MacGill	マギル、マッギル
MacGregor	マグレガー（マクレガー）
MacIntosh	マッキントッシュ
MacIntyre	マッキンタイヤー
Mack	マック
MacKay	マカーイ、マッケイ
MacKenzie	マッケンジー
MacKey	マッキー
MacKie	マッキー
MacKinlay	マッキンレイ
MacKintosh	マッキントッシュ
MacLaine	マクレーン
MacLaughlin	マクラフリン
Maclaurin	マクローリン
MacLean	マクレーン
MacLeod	マクラウド
MacMahon	マクマホン
MacManus	マクマナス
MacMillan	マクミラン
Macnaghten	マクノートン
MacNair	マクネアー
MacNeice	マクニース
MacNeil	マクニール
MacNeill	マクニール
MacSweeney	マクスウィーニー
Macy	メイシー
Maddrell	マッドレル
Maguire	マグワイア
Mahoney	マホーニー、マーニー
Maihew	メイヒュー
Maitland	メイトランド
Major	メイジャー
Makepeace	メイクピース
Mallett	マレット
Malory	マロリー
Malthouse	モルトハウス
Malthus	マルサス
Mansfield	マンスフィールド
Maple	メイプル、メープル
Marett	マレット
Markham	マーカム
Marland	マーランド
Marlborough	マールバラ
Marlowe	マーロー
Marquat	マーケット
Marr	マー
Marriott	マリオット
Marsh	マーシュ
Marshall	マーシャル
Martin	マーティン
Martinson	マーティンソン
Marven	マーヴェン
Masefield	メイスフィールド
Mason	メイスン
Massey	マッシー
Masters	マスターズ
Matheson	マシソン、マセソン
Matthews	マシューズ
Mauchly	モークリー
Maudslay	モーズレイ
Maugham	モーム
Maxwell	マクスウエル
May	メイ
Mayer	マイヤー
Mayfield	メイフィールド
Mayhew	メイヒュー
Maynard	メイナード
Mayweather	メイウェザー
Maywood	メイウッド
McAleese	マッカリース
McAllister	マカリスター
McAlmont	マッカルモント
McAlpine	マカパイン
McArthur	マカーサー、マッカーサー
McAvoy	マカヴォイ
McBein	マクベイン
McBrain	マクブレイン、マクブライン
McBride	マクブライド
McCabe	マッケイブ
McCafferty	マッカファーティ
McCall	マッコール
McCallum	マッカラム
McCann	マッカン
McCarroll	マッキャロル
McCarthy	マッカーシー
McCartney	マッカートニー
McCarty	マッカーティ
McClellan	マクレラン
McClintock	マクリントック
McClure	マクルーア
McColgan	マッコルガン
McCollum	マッコーラム
McConnell	マコーネル
McCorkell	マッコーケル
McCormack	マコーマック
McCormick	マコーミック
McCorquodale	マッコーコデール
McCoy	マッコイ
McCullagh	マカラー、マッカラー
McCullin	マッカラン、マカラン
McCulloch	マッカロク
McCullough	マッカロー
McDonald	マクドナルド
McDonnell	マクドネル
McDougall	マクドゥーガル
McDowell	マクダウェル
McElhiney	マケルハイニー
McElwee	マケルウィー
McEvoy	マカヴォイ
McFadden	マクファーデン
McFarlane	マクファーレン
McGill	マギル、マッギル
McGinnis	マギニス（マクギニス）
McGlynn	マクグリン
McGonagle	マゴーナグル
McGough	マガフ
McGovern	マガヴァーン（マクガヴァン）
McGregor	マグレガー（マクレガー）
McGuigan	マギーガン
McGwire	マグワイア
McHugh	マキュー
McIntosh	マッキントッシュ
McIntyre	マッキンタイア
McKane	マッケイン
McKay	マッカイ、マッケイ
McKeavney	マキーヴニー
McKee	マッキー
McKellen	マッケラン
McKenna	マッケナ、マッケンナ
McKennitt	マッケニット
McKenzie	マッケンジー
McKeone	マキオン
McKeown	マッケオン
McKernan	マカーナン、マッカーナン
McKerrow	マッケロー、マッケロウ
McKie	マッキー
McKinney	マッキニー
McKinnon	マッキノン
McKintosh	マッキントッシュ
McKnight	マクナイト
McLagan	マクレガン
McLaglen	マクラグレン
McLaren	マクラーレン、マクラレン
McLaughlin	マクロフリン
McLean	マクリーン、マクレーン
McLennan	マクレナン
McLeod	マクラウド
McLoughlin	マクローリン
McLuhan	マクルーハン
McMahon	マクマホン
McMaster	マクマスター
McMath	マクマス、マックマス
McMillan	マクミラン
McMurtry	マクマートリー
McNair	マクネアー
McNally	マクナリー
McNamara	マクナマラ
McNulty	マクナルティ
McOnie	マコニー、マッコニー
McPartland	マクパートランド
McPhail	マクフェイル
McPhee	マクフィー
McPherson	マクファーソン
McQueen	マクィーン、マックイーン
McRae	マクレイ
McSorley	マクソーリー
McTeer	マクティア
McVie	マクヴィー
McWilliams	マクウィリアムズ
Mear	ミアー
Meegan	ミーガン
Meehan	ミーハン
Melbourne	メルボーン
Mellers	メラーズ
Melville	メルヴィル
Mercury	マーキュリー
Meredith	メレディス
Merrigan	メリガン
Merrill	メリル
Merwin	マーウィン
Miall	マイアル
Michael	マイケル
Middleton	ミドルトン
Mill	ミル
Millar	ミラー
Miller	ミラー
Mills	ミルズ
Milne	ミルン
Milnes	ミルンズ
Milton	ミルトン
Milward	ミルワード
Minter	ミンター
Minton	ミントン
Mitchell	ミッチェル
Mixon	ミクソン
Moffat	モファット
Moffett	モフェット
Mogan	モーガン
Mogg	モグ
Mogridge	モグリッジ
Moleyns	モリンズ
Moloney	マロニー
Monaghan	モナハン
Monckton	モンクトン
Moncrief	モンクリーフ
Monroe	モンロー
Montagu	モンタギュー
Montague	モンタギュー
Monteith	モンティース、モンティス
Montgomery	モンゴメリ
Moodie	ムーディ
Moon	ムーン
Mooney	ムーニー
Moorcroft	ムーアクロフト
Moore	ムーア
Moorehead	ムーアヘッド
Morahan	モラハン
Moran	モラン
More	モア
Morgan	モーガン
Morgans	モーガンズ
Morlan	モーラン
Morley	モーリー
Moroney	モロニー
Morpeth	モーペス
Morphew	モーフュー
Morris	モーリス
Morrison	モリスン
Morrissey	モリッシー
Morrow	モロー、モロウ
Morse	モース（モールス）
Mort	モート
Mortimer	モーティマー
Morton	モートン
Moseley	モーズリー
Moses	モージズ、モーゼズ
Mosley	モーズリー
Moss	モス
Mott	モット
Mottelay	モットレイ
Moulding	モールディング
Muggeridge	マガーリッジ、マガリッジ
Muir	ミューア
Muirhead	ミュアヘッド
Mulcahy	マルケイヒー
Mulligan	マリガン
Mundy	マンディ
Munro	マンロー
Munroe	マンロー
Murdoch	マードック
Murdock	マードック
Murphy	マーフィー
Murray	マリー
Murt	マート
Musgrave	マスグレイヴ
Musson	マッソン
Mutton	マットン
Mycroft	マイクロフト
Myler	マイラー
Napier	ネイピア
Nash	ナッシュ
Neal	ニール
Neely	ニーリー
Neeson	ニースン
Nelson	ネルソン、ネルスン
Nettleship	ネトルシップ
Neville	ネヴィル
Newell	ニューウェル
Newhouse	ニューハウス
Newlands	ニューランズ
Newman	ニューマン
Newmark	ニューマーク
Newton	ニュートン
Nicell	ナイセル
Nicholls	ニコルズ
Nichols	ニコルズ
Nicholson	ニコルソン
Nicks	ニックス
Nicol	ニコル
Nicolson	ニコルソン
Nipher	ニファー
Nish	ニッシュ
Nixon	ニクソン
Noakes	ノークス
Noel	ノエル
Nolan	ノーラン
Nordley	ノードリー
Norfolk	ノーフォーク
Norman	ノーマン
Norris	ノリス
Norrish	ノーリッシュ
North	ノース
Northam	ノーサム
Northmore	ノースモア
Northrop	ノースロップ
Norton	ノートン
O'Brian	オブライアン
O'Brien	オブライエン
O'Byrne	オバーン
O'Callaghan	オキャラハン
O'Casey	オケーシー
O'Connell	オコンネル
O'Connor	オコーナー
O'Crowley	オクロウリー
O'Doherty	オドーアティ
O'Donnell	オドンネル
O'Donoghue	オドノヒュー
O'Duffy	オダフィ
O'Fallon	オファロン
O'Farrell	オファレル
O'Flaherty	オフラハティ
O'Grady	オグレイディ
O'Hara	オハラ
O'Hare	オヘア
O'Herlihy	オハリヒー
O'Higgins	オヒギンズ
O'Keeffe	オキーフ
O'Kelly	オケリー
O'Leary	オリーリー、オリアリー
O'List	オリスト
O'Malley	オマリー
O'Meara	オメーラ
O'Neill	オニール
O'Reilly	オライリー
O'Riordan	オリオーダン
O'Rourke	オローク
O'Shaughnessy	オショーネシー
O'Shea	オシェイ
O'Sullivan	オサリヴァン
O'Toole	オトゥール
Oakes	オークス
Oakeshott	オークショット
Oakwood	オークウッド
Oates	オーツ
Occleve	オクリーヴ
Odam	オーダム
Odets	オーデッツ
Odum	オーダム
Offley	オフリー
Ogburn	オグバーン
Ogden	オグデン
Ogg	オッグ
Oldcastle	オールドカースル
Oldfield	オールドフィールド
Oldham	オールダム
Oldman	オールドマン
Oliphant	オリファント
Oliver	オリヴァー
Olivier	オリヴィエ
Olmsted	オルムステッド
Olney	オルニー
Olsen	オルセン
Olyphant	オリファント
Oman	オーマン
Onions	オニオンズ
Orange	オレンジ
Ormond	オーモンド
Orr	オア
Orwell	オーウェル
Osbern	オズバーン
Osborn	オズボーン
Osborne	オズボーン
Osbourne	オズボーン
Otis	オーティス
Otway	オトウェイ
Oudney	オードニー
Oughtred	オートレッド
Ovett	オヴェット
Owen	オーウェン、オーエン
Owens	オウエンズ、オーウェンズ
Oxford	オックスフォード
Oxley	オクスリー、オックスリー
Pace	ペイス
Packer	パッカー
Page	ペイジ
Paice	ペイス
Pain	ペイン
Paley	ペイリー
Palin	ペイリン
Palmer	パーマー
Pape	ペイプ
Pargeter	パージター
Park	パーク
Parker	パーカー
Parkes	パークス
Parkin	パーキン
Parkins	パーキンズ
Parkinson	パーキンソン
Parr	パー
Parry	パリー
Parsons	パーソンズ
Partland	パートランド
Partridge	パートリッジ
Pascoe	パスコー
Paston	パストン
Paterson	パターソン
Patten	パッテン
Pattenden	パテンデン
Patterson	パターソン
Paulson	ポールソン
Paxton	パクストン
Payne	ペイン
Peabody	ピーボディ
Peace	ピース
Peake	ピーク
Peakman	ピークマン
Pearce	ピアース
Pearl	パール
Pearson	ピアソン
Pease	ピーズ
Peel	ピール
Peirce	パース
Pelham	ペラム
Pelling	ペリング
Pemberton	ペンバートン
Pendry	ペンドリー
Penford	ペンフォード
Pennington	ペニントン
Penry	ペンリー
Pepper	ペッパー
Perceval	パーシヴァル
Percy	パーシー
Perkins	パーキンス
Perks	パークス
Perrers	ペラーズ
Perry	ペリー
Pershing	パーシング
Pester	ペスター
Peters	ピーターズ
Peyton	ペイトン
Phelan	フィーラン
Philips	フィリップス
Phillips	フィリップス
Phillipson	フィリップソン
Phillpotts	フィルポッツ
Philpot	フィルポット
Phoenix	フェニックス
Pickering	ピカリング
Pickles	ピックルズ
Pierce	ピアース
Pilcher	ピルチャー
Pilkington	ピルキントン
Pincott	ピンコット
Pinter	ピンター
Pirie	ピリー
Pitman	ピットマン
Pitt	ピット
Pitts	ピッツ
Plaisted	プレイステッド
Plant	プラント
Plender	プレンダー
Plowright	プロウライト
Pointer	ポインター
Pollock	ポロック
Ponting	ポンティング
Poole	プール
Porter	ポーター
Postlethwaite	ポスルスウェイト
Poswell	ポズウェル
Potter	ポッター
Pottinger	ポッティンジャー
Potts	ポッツ
Powell	パウエル
Power	パワー
Preece	プリース
Prescott	プレスコット
Press	プレス
Preston	プレストン
Price	プライス
Prichard	プリチャード
Pridgen	プリジェン
Pridmore	プリッドモア
Priestley	プリーストリー
Prime	プライム
Primrose	プリムローズ
Pritchett	プリチェット
Probert	プロバート
Prosser	プロッサー
Proudfoot	プラウドフット
Prouse	プラウス
Prowse	プラウズ
Pryce	プライス
Pugh	ピュー
Purcell	パーセル
Pyle	パイル
Quaife	クゥエイフ
Quemby	クェンビー
Quigley	クイグリー
Quilter	クィルター
Quin	クィン
Quine	クワイン
Quinlan	クィンラン
Quinn	クィン
Quinton	クィントン
Quirk	クアーク
Rabkin	ラブキン
Rackham	ラッカム
Radcliffe	ラドクリフ
Radford	ラドフォード
Rae	レイ
Rafferty	ラファティ
Raikes	レイクス
Raine	レイン
Rainwater	レインウォーター
Rake	レイク
Raleigh	ローリー
Rampling	ランプリング
Ramsay	ラムゼイ
Ramsey	ラムジー
Rance	ランス
Rand	ランド
Randall	ランドル
Randolph	ランドルフ
Rangeley	レンジリー
Rankin	ランキン
Ransome	ランサム
Rapp	ラップ
Raskin	ラスキン
Ratcliffe	ラトクリフ
Rathbone	ラスボーン
Ratledge	ラトリッジ
Ravenscroft	レイヴンズクロフト
Rawle	ロール、ロウル
Rawsthorne	ロースソーン
Ray	レイ
Raymond	レイモンド
Raynor	レイナー
Read	リード
Reade	リード
Reber	リーバー
Recorde	レコード
Reddie	レディー
Redding	レディング
Reddington	レディントン
Redfield	レッドフィールド
Redford	レッドフォード
Redgrave	レッドグレイヴ、レッドグレーヴ
Redmayne	レッドメイン
Redmond	レドモンド
Redrup	レッドラップ
Reece	リース
Reed	リード
Rees	リース
Reese	リース
Reeves	リーヴズ
Regan	リーガン
Reid	リード
Reilly	ライリー
Relf	レルフ
Remington	レミントン
Renfield	レンフィールド
Renshaw	レンショー
Reston	レストン
Reuther	ルーサー
Revere	リヴィア
Reyleigh	レーリー
Reynolds	レイノルズ
Rhodes	ローズ
Rice	ライス
Rich	リッチ
Richards	リチャーズ
Richardson	リチャードソン
Richmond	リッチモンド
Rickman	リックマン
Rickwood	リックウッド
Riddell	リドル
Riddle	リドル
Rider	ライダー
Ridgway	リッジウェイ
Ridley	リドリー
Ridout	リダウト
Riesman	リースマン
Rifkined	リフキンド
Rigby	リグビー
Riley	ライリー
Rimmell	リンメル
Rimmer	リマー
Rimmington	リミントン
Riordan	リオーダン
Ritchie	リッチー
Roache	ローチ
Roberts	ロバーツ
Robertson	ロバートソン
Robins	ロビンズ
Robinson	ロビンソン
Robson	ロブソン
Rockefeller	ロックフェラー
Rockingham	ロッキンガム
Rockwell	ロックウェル
Rodford	ロッドフォード
Rodger	ロジャー
Rodgers	ロジャーズ
Rodham	ローダム
Rodney	ロドニー
Roger	ロジャー
Rogers	ロジャーズ
Ronan	ローナン
Rooke	ルーク
Rooney	ルーニー
Roosevelt	ルーズヴェルト
Root	ルート
Rootham	ルーサム
Roper	ローパー
Rose	ローズ
Ross	ロス
Rosser	ロッサー
Rosseter	ロセター
Rothery	ロザリー
Rowland	ローランド
Rowlands	ローランズ
Rowlatt	ローラット
Rowling	ローリング
Rowntree	ラウントリー
Roy	ロイ
Royce	ロイス
Royle	ロイル
Rudman	ルドマン
Rumbelow	ランブロウ
Runchman	ランチマン
Runciman	ランシマン
Rundall	ランドール
Rush	ラッシュ
Ruskin	ラスキン
Russ	ラス
Russell	ラッセル
Rust	ラスト
Ruth	ルース
Rutherford	ラザフォード
Rutland	ラトランド
Ryan	ライアン
Rylands	ライランズ
Ryle	ライル
Ryles	ライルズ
Sabine	セービン
Saintsbury	センツベリー
Salinger	サリンジャー
Salisbury	ソールズベリー
Salk	ソーク
Sallis	サリス
Samms	サムズ
Sampson	サンプソン
Samson	サムソン
Samwell	サムウェル
Sanders	サンダーズ
Sanderson	サンダーソン
Sandford	サンドフォード
Sands	サンズ
Sangster	サングスター
Sansom	サンソム
Sargent	サージェント
Saunders	ソーンダーズ
Savery	セヴァリー
Sawyer	ソーヤー
Saxon	サクソン
Sayers	セイヤーズ
Scale	スケール
Scanlan	スカンラン
Scarfe	スカーフ
Schlesinger	スレシンジャー
Scholes	スコールズ
Scotney	スコットニー
Scott	スコット
Scriven	スクリヴン
Scully	スカリー
Seager	シーガー
Seagrove	シーグローヴ
Seale	シール
Seals	シールズ
Seaman	シーマン
Sear	シアー
Searle	サール
Sears	シアーズ
Seaton	シートン
Seberg	セバーグ
Sedgwick	セジウィック
Seeley	シーリー
Seiwell	シーウェル
Selden	セルデン
Selfe	セルフ
Seligman	セリグマン
Sellers	セラーズ
Selsam	セルザム
Selvidge	セルヴィッジ
Selway	セルウェイ
Selwyn	セルウィン
Sennett	セネット
Sensible	センシブル
Service	サーヴィス
Sessions	セッションズ
Seton	シートン
Sewell	スーウェル、シーウェル
Sexby	セクスビー
Sexton	セクストン
Seymour	シーモア
Shaftesbury	シャフツベリー
Shakespeare	シェークスピア
Shaman	シャーマン
Shamrock	シャムロック
Shankly	シャンクリー
Shannon	シャノン
Sharman	シャーマン
Sharp	シャープ
Sharpe	シャープ
Sharrock	シャーロック
Shaughnessy	ショーネシー
Shaw	ショー、ショウ
Shearer	シアラー
Shearsmith	シアースミス
Sheehan	シーン
Sheen	シーン
Sheeran	シーラン
Sheffield	シェフィールド
Shelley	シェリー
Shelvey	シェルヴィー
Shepherd	シェパード
Sheppard	シェパード
Sheridan	シェリダン
Sheringham	シェリンガム
Sherry	シェリー
Sherwood	シャーウッド
Sheward	シュワード
Shield	シールド
Shirley	シャーリー
Shoebridge	シューブリッジ
Shoemaker	ショーメイカー
Shortt	ショート
Sidney	シドニー
Sillitoe	シリトー
Simm	シム
Simmons	シモンズ
Simon	サイモン
Simons	シモンズ
Simpson	シンプソン
Sinclair	シンクレア
Sinfield	シンフィールド
Sisley	シズリー（シスレー）
Skeffington	スケフィントン
Skelding	スケルディング
Skinner	スキナー
Skone	スコーン
Slade	スレイド
Slater	スレーター
Slattery	スラットリー
Sloan	スローン
Slocombe	スロコンブ
Sly	スライ
Smallwood	スモールウッド
Smart	スマート
Smith	スミス
Smyth	スミス
Smythe	スマイス
Snell	スネル
Snelling	スネリング
Snow	スノー
Soane	ソーン
Soddy	ソディー
Sollars	ソラーズ
Solley	ソリー
Solow	ソロウ
Somers	ソマーズ
Soper	ソーパー
Sorby	ソルビー
Sotherland	サザランド
Sotherton	ソザートン
Soule	ソウル
Sowell	ソーウェル
Spark	スパーク
Speake	スピーク
Spearing	スピアリング
Spedding	スペディング
Spence	スペンス
Spencer	スペンサー
Spendlove	スペンドラヴ
Spenser	スペンサー
Spiers	スパイアーズ
Spooner	スプーナー
Spring	スプリング
Springfield	スプリングフィールド
Spurgeon	スパージョン
Squire	スクワイア
Stacey	ステイシー
Stainton	ステイントン
Stamp	スタンプ
Standing	スタンディング
Stanfield	スタンフィールド
Stanford	スタンフォード
Stanley	スタンリー（スタンレイ）
Stansfield	スタンスフィールド
Stanton	スタントン
Stapledon	ステイプルドン
Staples	ステイプルズ
Stapleton	ステイプルトン
Star	スター
Starkey	スターキー
Starrett	スタレット、スターレット
Steel	スティール
Steele	スティール
Steiner	スタイナー
Stephen	スティーヴン
Stephens	スティーヴンズ
Stephenson	スティーヴンソン
Stepney	ステップニー
Sterling	スターリング
Sterne	スターン
Sterry	ステリー
Steuart	スチュアート
Stevens	スティーヴンズ
Stevenson	スティーヴンソン
Steward	スチュワード
Stewart	スチュアート
Stiles	スタイルズ
Stirling	スターリング
Stockdale	ストックデイル
Stockwin	ストックウィン
Stokes	ストークス
Stone	ストーン
Stoney	ストーニー
Stoppard	ストッパード
Storace	ストレイス
Storey	ストーリー
Stowe	ストウ
Street	ストリート
Stride	ストライド
Stuart	スチュアート
Stubbs	スタッブズ
Stynes	スタインズ
Such	サッチ
Suckville	サックウィル
Sullivan	サリヴァン
Summerhayes	サマーヘイズ
Summers	サマーズ
Summerskill	サマースキル
Sumner	サムナー
Sutcliff	サトクリフ
Sutherland	サザーランド
Sutton	サットン
Swan	スワン
Sweeney	スウィニー、スウィーニー
Sweetman	スウィートマン
Swift	スウィフト
Swingler	スウィングラー
Swinnerton	スウィンナートン
Syers	サイアーズ
Sykes	サイクス
Symes	サイムズ
Tait	テート
Talbot	タルボット、トールボット
Talcott	タルコット
Tallis	タリス
Tanner	タナー
Tarrant	ターラント
Tasker	タスカー
Tatchell	タッチェル
Tate	テート
Taverner	タヴァナー
Tawney	トウニー
Tayler	テイラー
Taylor	テイラー
Telford	テルフォード
Temperton	テンパートン
Temple	テンプル
Tennant	テナント
Tenniel	テニエル
Tennyson	テニソン
Tester	テスター
Thackeray	サッカレー
Thackwell	サックウェル
Thatcher	サッチャー
Thayer	セアー
Theiler	セイラー
Thewlis	シューリス
Thokell	ソーケル
Thomas	トーマス
Thompson	トンプソン
Thomson	トムソン
Thorn	ソーン
Thorndike	ソーンダイク
Thorne	ソーン
Thornhill	ソーンヒル
Thornley	ソーンリー
Thornton	ソーントン
Thorpe	ソープ
Thurgood	サーグッド
Thurman	サーマン
Tierney	ティアニー
Tillett	ティレット
Tillotson	ティロトソン
Tillyard	ティリャード
Timberlake	ティンバーレイク
Tiner	タイナー
Tippett	ティペット
Tiptoft	ティプトフト
Titchmarsh	ティッチマーシュ
Tobias	トバイアス
Tohill	トヒル
Tolman	トールマン
Tomlins	トムリンズ
Took	トゥック
Toomey	トゥーミー
Tovey	トーヴィー
Towler	トウラー
Townsend	タウンゼント
Townshend	タウンゼント
Toye	トイ
Toynbee	トインビー
Tragett	トラジェット
Travers	トラヴァーズ
Traylor	トレイラー
Traynor	トレイナー
Trevor	トレヴァー
Trewavas	トレワヴァス
Truman	トルーマン
Tucker	タッカー
Tudor	テューダー
Tunstall	タンストール
Turnbull	ターンブル
Turner	ターナー
Turnour	ターナー
Twigger	トゥイガー
Tye	タイ
Tyler	タイラー
Tyndale	ティンダル
Tyrwhitt	ティリット
Tysoe	タイソー
Underhill	アンダーヒル
Underwood	アンダーウッド
Uniacke	ユニアック
Upshaw	アップショー
Upson	アップソン
Urquhart	アーカート
Utley	アトリー
Uttley	アトリー
Vaughan	ヴォーン
Vernon	ヴァーノン
Vickers	ヴィッカーズ
Vincent	ヴィンセント
Waddingham	ワディンガム
Waddington	ウォーディントン
Wade	ウェイド
Wain	ウェイン
Wainwright	ウェインライト
Wakeling	ウェイクリング
Wakeman	ウェイクマン
Waldron	ウォルドロン
Wales	ウェールズ
Walford	ウォルフォード
Walker	ウォーカー
Walkinshaw	ウォーキンショー
Wall	ウォール
Wallace	ウォレス、ウォリス
Walpole	ウォルポール
Walsh	ウォルシュ
Walter	ウォルター
Walters	ウォルターズ
Walthew	ウォルシュー
Walton	ウォルトン
Warbeck	ウォーベック
Ward	ウォード
Warham	ウォーラム
Warleigh	ウォーレイ
Warlock	ウォーロック
Warner	ワーナー
Warren	ウォーレン
Warrilow	ウォリロウ
Warriner	ウォリナー
Washbourne	ウォッシュボーン
Washburn	ウォッシュバーン
Washington	ワシントン
Waterhouse	ウォーターハウス
Waters	ウォーターズ
Watkinson	ワトキンソン
Watmore	ワットモア
Watson	ワトソン、ワトスン
Watt	ワット
Watts	ワッツ
Waugh	ウォー
Waylett	ウェイレット
Wayne	ウェイン
Webb	ウェッブ
Webber	ウェッバー
Webster	ウェブスター
Wedgwood	ウェッジウッド
Weeden	ウィーデン
Weight	ウェイト
Weinberg	ワインバーグ
Weinberger	ワインバーガー
Weir	ウィアー
Welbourn	ウェルボーン
Welch	ウェルチ
Weller	ウェラー
Welles	ウェルズ
Wellesley	ウェルズリー
Wellington	ウェリントン
Wells	ウェルズ
Welsh	ウェルシュ
Welton	ウェルトン
Welty	ウェルティ
Wentworth	ウェントワース
Wesley	ウェズリー
West	ウェスト
Westbrook	ウェストブルック
Westmoreland	ウェストモアランド
Weston	ウェストン
Westwick	ウェストウィック
Westwood	ウエストウッド
Wetton	ウェットン
Weymouth	ウェイマス
Whalley	ウォーリー
Wharton	ウォートン
Wheatley	ウィートリー
Wheatstone	ホイートストン
Wheeldon	ウィールドン
Wheeler	ウィーラー
Wheelwright	ウィールライト
Whelan	ウィーラン
Whelbourne	ウェルボーン
Whight	ライト
Whishaw	ウィショー
Whistler	ホイッスラー
Whiston	ホイストン
Whitaker	ウィテカー、ウィティカー
Whitbread	ウィットブレッド
White	ホワイト
Whitefield	ホワイトフィールド
Whitehead	ホワイトヘッド
Whiteley	ホワイトリー
Whiteway	ホワイトウェイ
Whitford	ウィットフォード
Whiting	ウィティング
Whitman	ホイットマン
Whitmore	ウィットモア
Whittington	ウィッティントン
Whittle	ウィットル
Whymper	ウィンパー
Whyte	ホワイト
Wiat	ワイアット
Wibberley	ウィバリー
Wickham	ウィッカム
Wickins	ウィッキンズ
Widdowson	ウィドーソン
Widdrington	ウィドリントン
Wight	ワイト
Wilberforce	ウィルバーフォース
Wilby	ウィルビー
Wilbye	ウィルビー
Wilcox	ウィルコックス
Wilde	ワイルド
Wilder	ワイルダー
Wilkes	ウィルクス
Wilkie	ウィルキー
Wilkins	ウィルキンズ
Wilkinson	ウィルキンソン
Wilks	ウィルクス
Willcocks	ウィルコックス
Williams	ウィリアムズ
Williamson	ウィリアムソン
Willis	ウィリス
Willmott	ウィルモット
Willoughby	ウィロビー
Wills	ウィルズ
Wilmington	ウィルミントン
Wilmot	ウィルモット
Wilson	ウイルソン
Wimberley	ウィンバリー
Wimbury	ウィンベリー
Winchcombe	ウィンチカム
Windsor	ウィンザー
Wingate	ウィンゲート
Wingfield	ウィングフィールド
Winslet	ウィンズレット
Winston	ウィンストン
Winstone	ウィンストン
Winter	ウィンター
Winters	ウィンターズ
Winterson	ウィンターソン
Winwood	ウィンウッド
Wirgman	ワーグマン
Wisdom	ウィズダム
Wise	ワイズ
Wishart	ウィシャート
Withers	ウィザーズ
Witherspoon	ウィザースプーン
Witting	ウィッティング
Witty	ウィッティー
Wodehouse	ウッドハウス
Wolf	ウルフ
Wolfenden	ウォルフェンデン
Wolsey	ウォルジー
Wolstenholme	ウォルステンホルム
Wood	ウッド
Woodman	ウッドマン
Woods	ウッズ
Woodville	ウッドヴィル
Woodward	ウッドワード
Woolf	ウルフ
Woolley	ウーリー
Wordsworth	ワーズワース
Worrall	ウォーラル
Worsley	ウォーズリー
Worthington	ワージントン
Wray	レイ
Wren	レン
Wrenn	レン
Wright	ライト
Wrigley	リグリー
Wroughton	ロウトン
Wulfstan	ウルフスタン
Wyatt	ワイアット
Wyeth	ワイエス
Wyld	ワイルド
Wyler	ワイラー
Wyman	ワイマン
Wymark	ワイマーク
Yardley	ヤードリー
Yarnold	ヤーノルド
Yates	イェイツ
York	ヨーク
Yorke	ヨーク
Young	ヤング
Younghusband	ヤングハズバンド
Zindell	ジンデル