Abenius	アベニウス
Åberg	オーバリ
Åbergsson	オーベリソン
Abrahamsson	アブラハムソン
Abramsson	アブラムソン
Adielsson	アディエルソン
Adolfsson	アドルフソン
Agrell	アグレル
Ågren	オーグレーン
Ahlberg	アールバリ
Åhlén	オリアン
Ahlgren	アールグレーン
Ahlkvist	アールクヴィスト
Ahlquist	アールクヴィスト
Ahlqvist	アールクヴィスト
Ahlstedt	アールステット
Åhlstedt	オールステット
Åhlström	オールストレーム
Ahlström	アールストレーム
Ahnsjö	アーンフェ
Ahrenberg	アーレンバリ
Åkerberg	オーケルバリ
Åkerfeldt	オーケルフェルト
Åkerhielm	オーケリエルム
Åkerlund	オーケルルンド
Åkerman	オーケルマン
Åkerström	オーケシュトレーム
Åkesson	オーケソン
Åkrans	オークランス
Alexandersson	アレクサンデション
Alfredsson	アルフレッドソン
Alfvén	アルヴェーン
Allbäck	アールベック
Allgulin	アルギュリーン
Almén	アルメン、アルメアン
Almer	アルマル、アルメル
Almgren	アルムグレーン
Almkvist	アルムクヴィスト
Almquist	アルムクヴィスト
Almqvist	アルムクヴィスト
Almström	アルムストレーム
Alström	アールストレーム
Althén	アルテアン
Älvestam	エルヴェスタム
Alvidson	アルヴィドソン
Amrén	アムレアン
Ander	アンデル
Anderberg	アンデルバリ
Andersson	アンデション
Andréason	アンドレアソン
Andreasson	アンドレアソン
Andree	アンドレー
Andrén	アンドレアン
Andrésen	アンドレセン
Ångström	オングストレーム（オングストローム）
Antonsson	アントンソン
Appelberg	アッペルバリ
Appelgren	アッペルグレーン
Appelkvist	アッペルクヴィスト
Appelman	アッペルマン
Appelquist	アッペルクヴィスト
Appelqvist	アッペルクヴィスト
Appeltofft	アッペルトフト
Armgren	アルムグレーン
Arnell	アーネル
Arnoldson	アルノルドソン
Arrelid	アレリード
Arrhenius	アレニウス
Aruhn	アルーン
Arvidson	アルヴィドソン
Arvidsson	アルヴィドソン
Arwidson	アルヴィドソン
Åsbrink	オースブリンク
Asker	アシェル
Åslund	オースルンド
Asper	アスペル
Asplund	アスプルンド
Asserholt	アッサルホルト
Åström	オーストレーム
Atterberg	アッテルバリ
Augustsson	アウグストソン
Aulin	アウリーン
Aurelius	アウレリウス
Axberg	アクスバリ
Axelson	アクセルソン
Axelsson	アクセルソン
Axén	アクセーン
Bäck	ベック
Backlin	バックリーン
Backlund	バックルンド
Backman	バックマン
Bäckström	ベックストレーム
Bartels	バルテルス
Bäverstam	ベーヴェルシュタム
Beckman	ベックマン
Been	ベーン
Bellman	ベルマン
Bendix	ベンディクス
Bengtsson	ベントソン
Berg	バーリ
Bergelin	バリエリーン
Bergendahl	バリエンダール
Bergenfeldt	バリエンフェルト
Bergenholm	バリエンホルム
Bergenkvist	バリエンクヴィスト
Bergenskjöld	バリエンフェルド
Bergenström	バリエンストレーム
Berger	バーリエル
Bergfelt	バーリフェルト
Bergfors	バーリフォーシュ
Berggren	バーリグレーン
Bergkvist	バーリクヴィスト
Berglin	バーリリーン
Berglind	バーリリンド
Bergling	バーリリン
Berglund	バーリルンド
Bergman	バーリマン（ベルイマン）
Bergquist	バーリクヴィスト
Bergqvist	バーリクヴィスト
Bergström	バーリストレーム
Berntsson	ベルントソン
Beronius	ベロニウス
Berwald	ベールヴァルド
Berzelius	ベルセリウス
Beyron	ベイロン
Bildt	ビルト
Billberg	ビルバリ
Björk	ビョルク
Björkegren	ビョルケグレーン
Björkenheim	ビョルケンヘイム
Björker	ビョルケル
Björkgren	ビョルクグレーン
Björklund	ビョルクルンド
Björkström	ビョルクストレーム
Björling	ビョルリン
Björlund	ビョルルンド
Björne	ビョルネ
Björnståhl	ビョルンストール
Björnstrand	ビョルンストランド
Bjurman	ビュールマン
Bladh	ブラード
Blixt	ブリクスト
Blom	ブローム
Blomberg	ブロムバリ
Blomdahl	ブロムダール
Blomkvist	ブロムクヴィスト
Blomquist	ブロムクヴィスト
Blomqvist	ブロムクヴィスト
Blomstedt	ブロムステット
Blomstrand	ブロムストランド
Bodström	ボードストレーム
Boklund	ボクルンド
Bollström	ボールストレーム
Boork	ボールク
Borelius	ボレリウス
Borgkvist	ボーリクヴィスト
Borgquist	ボーリクヴィスト
Borgqvist	ボーリクヴィスト
Borgström	ボーリストレーム
Boström	ボーストレーム
Brandström	ブランドストレーム
Brandt	ブラント
Brännberg	ブレンバリ
Brännström	ブレンストレーム
Brant	ブラント
Bredefeldt	ブレーデフェルト
Brendler	ブレンドレル
Brilioth	ブリリオート
Brolin	ブロリーン
Broman	ブローマン
Broström	ブローストレーム
Brunell	ブルネッル
Brynolfsson	ブリノルフソン
Byström	ビューストレーム
Carlson	カールソン
Carlsson	カールソン
Carlstedt	カールステット
Carlstein	カールシュテイン
Cassel	カッセル
Cederberg	セーデルバリ
Cederblad	セーデルブラード
Cederborg	セーデルボリ
Cederfelt	セーデルフェルト
Cedergren	セーデルグレーン
Cederlund	セーデルルンド
Christoffersson	クリストフェション
Cronheim	クロンヘイム
Cronquist	クロンクヴィスト
Cronqvist	クロンクヴィスト
Cullberg	クールバリ
Dahl	ダール
Dahlbäck	ダールベック
Dahlberg	ダールバリ
Dahlén	ダリアン
Dahlgren	ダールグレン
Dahlin	ダリーン
Dahlkvist	ダールクヴィスト
Dahlman	ダールマン
Dahlquist	ダールクヴィスト
Dahlqvist	ダールクヴィスト
Dahlström	ダールストレーム
Danielsson	ダニエルソン
Davidson	ダヴィッドソン
Davidsson	ダーヴィドソン
Dinkela	ディンケラ
Dixgård	ディクスゴード
Dunkels	ドゥンケルス
Eckerberg	エッケルバリ
Edberg	エドバリ
Edén	エデーン
Edfeldt	エドフェルト
Edin	エディーン
Edlund	エードルンド
Edström	エドストレーム
Edvinsson	エドヴィンソン
Edwall	エドヴァール
Egerstrand	エーゲシュトランド
Ehrén	エレーン
Ehrling	エールリン
Ehrsson	エーション
Ejderstedt	エイデシュテット
Ek	エック、エーク
Ekblad	エクブラード
Ekblom	エクブロム
Ekdal	エクダル
Ekeberg	エーケバリ
Ekedahl	エーケダール
Ekendahl	エーケンダール
Ekerot	エーケロート
Ekholm	エクホルム
Eklöf	エクレフ
Eklund	エクルンド
Eklundh	エクルンド
Ekman	エクマン、イェクマン
Ekstedt	エクステット
Ekstrand	エクストランド
Ekström	エクストレーム
Ekvall	エクヴァル
Ekwall	エクヴァル
Elffors	エルフフォーシュ
Elg	エリ
Eliasson	エリアソン
Elmander	エルマンデル
Enander	エナンデル
Enberg	エーンバリ
Endén	エンデン
Eneström	イェネストレーム、エーネストレーム
Engberg	エングバリ
Engblom	エングブロム
Engdahl	エングダール
Engeström	エンニェストレーム
Engfeldt	エングフェルト
Engfelt	エングフェルト
Engholm	エングホルム
Engkvist	エングクヴィスト
Englund	エングルンド
Engquist	エングクヴィスト
Engqvist	エングクヴィスト
Engstrand	エングストランド
Engström	エングストレーム
Enkvist	エンクヴィスト
Enquist	エンクヴィスト
Enqvist	エンクヴィスト
Enroth	エンロート
Enström	エンストレーム
Ericksson	エリクソン
Ericson	エリクソン
Ericsson	エリクソン
Erikson	エリクソン
Eriksson	エリクソン
Erlander	エルランデル
Erlandsson	エルランドソン
Erlingmark	エリングマルク
Eurenius	エウレニウス
Evander	エヴァンデル
Eyser	エイセル
Fagerholm	ファーゲルホルム
Fagerlin	ファーゲルリーン
Fagerlund	ファーゲルルンド
Fagerström	ファーゲシュトレーム
Fahlcrantz	ファールクランツ
Falk	ファルク
Fälldin	フェルディーン
Fallenius	ファッレニウス
Feldt	フェルト
Fernholm	フェルンホルム
Fernström	フェルンストレーム
Fersen	フェルセン
Fjällström	フィェルストレーム
Florman	フロールマン
Fogelberg	フォーゲルバリ
Fogelin	フォーゲリーン
Fogelklou	フォーゲルクロウ
Fogelström	フォーゲルストレーム
Fogelund	フォーゲルンド
Fohlin	フォーリーン
Forsberg	フォーシュバリ
Forsell	フォシェル、フォーセル
Forsén	フォルシアン
Forsius	フォルシウス
Forslund	フォーシュルンド
Forsman	フォシュマン
Forssell	フォッシェル
Forssen	フォシェーン
Fransson	フランソン
Franzen	フランセーン
Fredenberg	フレーデンバリ
Fredholm	フレドホルム
Fredriksson	フレドリクソン
Freivalds	フレイヴァルツ
Fridegård	フリーデゴード
Fridell	フリデール
Fridén	フリーデン
Fridolin	フリードリーン
Frieberg	フリーバリ
Fröling	フレーリン
Frydén	フリュデン
Frykberg	フリュクバリ
Fryklof	フリュクレフ
Fryklund	フリークルンド
Fryxell	フリクセル
Gabrielsson	ガブリエルソン
Gärderud	ヤーデルード
Garmstedt	ガルムステット
Gatugård	ゴートゥゴード
Gedda	ゲッダ
Gefors	イェフォーシュ
Gegerfelt	イェーゲルフェルト
Geijer	イェイエル
Geist	イェイスト
Göransson	ヨーランソン
Görlin	ヨルリーン
Grafström	グラーフストレーム
Granberg	グランバリ
Granfeldt	グランフェルト
Granfelt	グランフェルト
Granholm	グランホルム
Grankvist	グランクヴィスト
Granlund	グランルンド
Granman	グランマン
Granquist	グランクヴィスト
Granqvist	グランクヴィスト
Granström	グランストレーム
Grevillius	グレヴィリウス
Grip	グリプ
Grönberg	グレンバリ
Grönlund	グレーンルンド
Grunden	グルンデン
Grundström	グルンドストレーム
Gulbranson	グルブランソン
Gullberg	グッルバリ
Gullbrandson	グルブランドソン
Gullstrand	グルストランド
Gunnarsson	グンナション
Gustafsson	グスタヴソン
Gustavson	グスタヴソン
Gustavsson	グスタフソン
Hafgren	ハフグレーン
Håfström	ホーフストレーム
Hagberg	ハグバリ
Håge	ホーゲ
Hagegård	ハーゲゴード
Hagelin	ハゲリーン
Hägg	ヘッグ
Hägglund	ヘッグルンド
Häggström	ヘッグストレーム
Haglund	ハーグルンド
Hagström	ハグストレーム
Hahn	ハーン
Håkansson	ホーカンソン
Halfvarsson	ハルフヴァション
Hållberg	ホールバリ
Hallén	ハリアン
Hällgren	ヘルグレーン
Hallhagen	ハルハーゲン
Hallin	ハリーン
Hallnäs	ハルネス
Hallonsten	ハロンステーン
Hallström	ハルストレーム
Hambraeus	ハンブレーウス
Hammarberg	ハンマルバリ
Hammargren	ハンマルグレーン
Hammarlund	ハンマルルンド
Hammarskjöld	ハマーフェルド
Hammarstrand	ハンマーシュトランド
Hammarström	ハンマーシュトレーム
Hammerth	ハンメルト
Hamrin	ハムリーン
Hanell	ハネル
Hansen	ハンセン
Hansson	ハンソン
Hård	ホード
Hartelius	ハルテリウス
Hasselberg	ハッセルバリ
Hasselblad	ハッセルブラード
Hasslo	ハスロ
Hazelius	ハセリウス
Hedar	ヘダー
Hedberg	ヘードバリ
Hedblom	ヘドブロム
Hedborg	ヘドボリ
Hedén	ヘデーン
Hedin	ヘディーン
Hedlund	ヘドルンド
Hedman	ヘドマン
Hedström	ヘードストレーム、ヘッドストレーム
Hedwall	ヘドヴァル
Heidenstam	ヘイデンスタム
Helenius	ヘレニウス
Helgesson	ヘルゲソン
Hellberg	ヘルバリ
Hellkvist	ヘルクヴィスト
Hellner	ヘルナル
Hellquist	ヘルクヴィスト
Hellqvist	ヘルクヴィスト
Hellstrand	ヘルストランド
Hellström	ヘルストレーム
Helmerson	ヘルメション
Henneberg	ヘンネバリ
Hennerberg	ヘンネルバリ
Henriksson	ヘンリクソン
Hermansson	ハールマンソン
Hermodsson	ヘルムドソン
Hertzberg	ハルツバリ
Hildingsson	ヒルディングソン
Hillborg	ヒルボリ
Hjalmarsson	ヤルマション
Hjelm	イェルム
Hjertén	ヤルテアン
Hjertstedt	ヤルトステット
Hjulström	ユルストレーム
Hofsten	ホフステーン
Högberg	ヘーグバリ
Höglind	ヘーグリンド
Höglund	ヘーグルンド
Högman	ヘーグマン
Högstedt	ヘーグステット
Högstrand	ヘーグストランド
Högström	ヘーグストレーム
Hök	ヘーク
Holewa	ホレヴァ
Holm	ホルム
Holmberg	ホルムバリ
Holmgren	ホルムグレーン
Holmkvist	ホルムクヴィスト
Holmlund	ホルムルンド
Holmquist	ホルムクヴィスト
Holmqvist	ホルムクヴィスト
Holmström	ホルムストレーム
Hörling	ホールリン
Hörnlund	ホルンルンド
Hultgren	フルトグレーン
Hultkrantz	フルトクランツ
Hultkvist	フルトクヴィスト
Hultman	フルトマン
Hultquist	フルトクヴィスト
Hultqvist	フルトクヴィスト
Husberg	フースバリ
Hylander	ヒュランデル
Idenstam	イーデンスタム
Igelström	イーゲルストレーム
Ingemarsson	インゲマション
Ingesson	インゲソン
Ingeström	インニェストレーム
Isaksson	イサクソン
Isfeldt	イスフェルト
Ivarsson	イーヴァション
Jacobson	ヤーコブソン
Jacobsson	ヤコブソン
Jäderholm	イェーデルホルム
Jåfs	ヨーフス
Jakobsson	ヤコブソン
Janols	ヤノルス
Jansson	ヤンソン
Järås	ヤーロース（イェールオース）
Järnefelt	ヤーネフェルト
Jennefelt	イェンネフェルト
Jeppsson	イェップソン
Jernberg	ヤルンバリ、イェルンベリ
Johanson	ヨーハンソン
Johansson	ヨハンソン
Johnsen	ヨンセン
Johnson	ヨンソン、ユーンソン
Johnsson	ヨンソン
Jonasson	ヨナソン
Jönsson	イェンソン
Jonsson	ヨンソン
Josefsson	ヨセフソン、ヨーセフソン
Josephson	ユーセフソン
Juhlin	ユーリーン
Juholt	ユーホルト
Kallela	カッレラ
Kallenberg	カッレンバリ
Kallstenius	カルステニウス
Källström	シェルストレーム
Kalm	カルム
Kamark	カマルク
Kamprad	カンプラード
Karlfeldt	カールフェルト
Karlgren	カールグレーン
Karlsson	カールソン
Karnéus	カルネウス
Kjaell	シェル
Kjellberg	シェルバリ
Kjellman	シェルマン
Kjellström	シェルストレーム
Kjörnsberg	ショルンスバリ
Klingenberg	クリンゲンバリ
Klingvall	クリングヴァル
Klum	クルーム
Knaust	クナウスト
Knutsson	クヌートソン
Koch	コック
Kollberg	コールバリ
Körberg	ショールバリ
Krantz	クランツ
Kristersson	クリステション
Kristiansson	クリスティアンソン
Kristoffersson	クリストッフェション
Kronberg	クロンバリ
Kvarnström	クヴァーンストレーム
Läckberg	レックバリ
Lagerbäck	ラーゲルベック
Lagerberg	ラーゲルバリ
Lagerblad	ラーゲルブラード
Lagercrantz	ラーゲルクランツ
Lagerfeldt	ラーゲルフェルト
Lagergren	ラーゲルグレーン
Lagerkvist	ラーゲルクヴィスト
Lagerlöf	ラーゲルレーヴ
Lagerquist	ラーゲルクヴィスト
Lagerqvist	ラーゲルクヴィスト
Lail	ライル
Landeskog	ランデスコーグ
Landström	ランドストレーム
Lång	ローン
Långström	ロングストレーム
Lannerbäck	ランナーベック
Lantz	ランツ
Larcén	ラルセン
Laretei	ラレテイ
Larsén	ラルセン
Larserud	ラーシャルード
Larson	ラーション
Larsson	ラーション
Laurin	ラウリーン
Laxström	ラクストレーム
Leanderson	レアンデション
Leijon	レイヨン
Leijonborg	レイヨンボリ
Lennartsson	レンナルトソン
Lennstrand	レンストランド
Lexell	レクセル
Leygraf	レイグラーフ
Lidholm	リードホルム
Lidman	リドマン
Lilja	リーリャ
Liljeberg	リリェバリ
Liljefors	リリェフォッシュ
Liljeholm	リリェホルム
Liljeström	リリェストレーム
Lillkvist	リルクヴィスト
Lillquist	リルクヴィスト
Lillqvist	リルクヴィスト
Lind	リンド
Lindahl	リンダール
Lindberg	リンドバリ
Lindblad	リンドブラード
Lindblom	リンドブロム
Lindborg	リンドボリ
Lindegård	リンデゴード
Lindegren	リンデグレーン
Lindell	リンデル
Linder	リンデル
Linderoth	リンデロート
Lindfors	リンドフォーシュ
Lindgren	リンドグレーン
Lindh	リンド
Lindhagen	リンドハーゲン
Lindholm	リンドホルム
Lindi	リンディ
Lindkvist	リンドクヴィスト
Lindman	リンドマン
Lindquist	リンドクヴィスト
Lindqvist	リンドクヴィスト
Lindroth	リンドロート
Lindstedt	リンドステット
Lindstrand	リンドストランド
Lindström	リンドストレーム
Lindvall	リンドヴァル
Lindwall	リンドヴァル
Linné	リネー
Ljung	ユーン
Ljungberg	ユングバリ、ユンバリ
Ljunggren	ユンググレーン、ユングレーン
Ljungkvist	ユングクヴィスト
Ljungman	ユングマン
Ljungquist	ユングクヴィスト
Ljungqvist	ユングクヴィスト
Ljungstedt	ユングステット
Ljungström	ユングストレーム
Löf	レーヴ
Löfgren	レーフグレーン
Löfkvist	レーフクヴィスト
Löfquist	レーフクヴィスト
Löfqvist	レーフクヴィスト
Löfven	レヴェーン、ロヴェーン
Lönnå	レンノ
Lönnberg	レーンバリ
Lönnholm	レンホルム
Lönnkvist	レンクヴィスト
Lönnquist	レンクヴィスト
Lönnqvist	レンクヴィスト
Lönnroth	レーンロート
Lövkvist	レーヴクヴィスト
Lovnér	ロヴネル
Löwenadler	レーヴェンアドレール
Löwenhielm	レーヴェンヒェルム
Lund	ルンド
Lundahl	ルンダール
Lundberg	ルンドバリ
Lundblad	ルンドブラード
Lundbohm	ルンドボーム
Lundeberg	ルンデバリ
Lundegård	ルンデゴード
Lundell	ルンデル
Lundgren	ルンドグレーン
Lundholm	ルンドホルム
Lundin	ルンディーン
Lundkvist	ルンドクヴィスト
Lundmark	ルンドマルク
Lundquist	ルンドクヴィスト
Lundqvist	ルンドクヴィスト
Lundsten	ルンドステーン
Lundström	ルンドストレーム
Lundvall	ルンドヴァル
Lundvik	ルンヴィク
Lundwall	ルンドヴァル
Magnusson	マグヌソン
Maier	マイエル
Malmberg	マルムバリ
Malmborg	マルムボリ
Malmer	マルメル
Malmfors	マルムフォーシュ
Malmgren	マルムグレーン
Malmkvist	マルムクヴィスト
Malmquist	マルムクヴィスト
Malmqvist	マルムクヴィスト
Malmros	マルムロース
Malmsjö	マルムフェ
Malmsten	マルムステーン
Malmström	マールムストレーム
Mandahl	マンダール
Mann	マン
Manner	マンナル、マンネル
Mannerheim	マンネルヘイム
Månsson	モンソン
Marklund	マルクルンド
Mårtenson	モーテンソン
Mårtensson	モルテンソン
Martinson	マルティンソン
Martinsson	マルティンソン
Mathsson	マットソン
Mattson	マットソン
Mattsson	マットソン
Meijer	メイイェル
Melander	メランデル
Melin	メリーン
Melkersson	メルケション
Mellberg	メルバリ
Mellin	メリーン
Mellnas	メルネス
Merits	マリーツ
Meschwitz	メシュヴィツ
Mild	ミルド
Milveden	ミルヴェーデン
Moberg	ムーバリ
Molander	モランデル
Moodysson	モーデュソン
Morberg	モルバリ
Morthensen	モッテンセン
Mosesson	モーセッソン
Myberg	ミューバリ
Myrberg	ミュルバリ
Myrdal	ミュルダール
Naumann	ナウマン
Nelldal	ネルダール
Nelson	ネルソン
Nelsson	ネルソン
Nerem	ネレム
Neumann	ノイマン
Nicander	ニカンデル
Nilsson	ニルソン
Nobel	ノベル、ノベール
Norberg	ノルバリ
Nordahl	ノルダール
Nordegren	ノルデグレーン
Norden	ノルデン
Nordenfelt	ノルデンフェルト
Nordenskiold	ノルデンショルド
Nordenson	ノルデンソン
Nordgren	ノルドグレーン
Nordin	ノルディーン
Nordkvist	ノルドクヴィスト
Nordlander	ノルドランデル
Nordlund	ノルドルンド
Nordman	ノルドマン
Nordquist	ノルドクヴィスト
Nordqvist	ノルドクヴィスト
Nordström	ノルドストレーム
Nordwall	ノルドヴァル
Norén	ノリアン
Norlander	ノルランデル
Norlén	ノルリアン
Norman	ヌールマン
Norrby	ノルビ
Norrman	ノルマン
Norstedt	ノシュテット
Norström	ノルシュトレーム
Nyberg	ニーバリ
Nyblom	ニーブロム
Nydahl	ニーダール
Nygren	ニーグレーン
Nyholm	ニーホルム
Nykvist	ニークヴィスト
Nylander	ニランデル
Nylén	ニリアン
Nylund	ニールンド
Nyman	ニーマン
Nyquist	ニークヴィスト
Nyqvist	ニークヴィスト
Nyrén	ニリアン
Nyström	ニーストレーム
Öberg	エーバリ
Odeberg	オーデバリ
Odelberg	オーデルバリ
Odell	オデッル
Odén	オデアン
Odenberg	オーデンバリ
Ohlin	オリーン、オーリーン
Ohlmarks	オールマルクス
Ohlsson	オールソン
Öhman	エーマン
Öhrnberg	エールンバリ
Öhrwall	エールヴァール
Olhester	オルヘスタル
Olin	オリーン
Olofsson	オロフソン
Olsson	オルソン
Oredsson	オーレドソン
Oscarius	オスカリウス
Oscarsson	オスカーション
Oskarsson	オスカーション
Östberg	エストバリ
Österberg	エステルバリ
Östergren	エステルグレーン
Österlund	エステルルンド
Österman	エステルマン
Östholm	エストホルム
Östling	エストリン
Östlund	エストルンド
Östlundh	エストルンド
Östman	エストマン
Ottosson	オットソン
Övergaard	エーベルゴード
Oxenstierna	オクセンシェルナ
Påhlsson	ポールソン
Palm	パルム
Palmborg	パルムボリ
Palmcrantz	パルムクランツ
Palme	パルメ
Palmgren	パルムグレーン
Pålson	ポールソン
Pålsson	ポルソン
Pärson	パーション
Patriksson	パトリクソン
Paulson	ポールソン
Paulsson	ポールソン
Perder	ペーデル
Pergament	ペルガメント
Persbrandt	パーシュブラント
Persson	パーション
Peterson	ペッテション
Petersson	ペッテション
Pettersson	ペッテション
Pleijel	プレイイェル
Pringle	プリングル
Rabe	ラーベ
Rådström	ロードストレーム
Rahm	ラーム
Randel	ランデル
Ranelid	ラーネリード
Rehn	レーン
Rehnkvist	レーンクヴィスト
Rehnquist	レーンクヴィスト
Rehnqvist	レーンクヴィスト
Reinfeldt	ラインフェルト
Rendahl	レンダール
Richardsson	リカルドソン
Ringberg	リングバリ
Ringdahl	リングダール
Ringholm	リングホルム
Ringkvist	リンクヴィスト
Rödin	レディーン
Rodin	ロディーン
Rödlund	レードルンド
Roman	ルーマン
Rönnegård	レンネゴード
Rosberg	ロースバリ
Rosén	ロセアン
Rosenberg	ローセンバリ
Rosenblad	ローセンブラード
Rosendahl	ローセンダール
Rosengren	ローセングレーン
Rosström	ルーストレーム
Rubenson	ルーベンソン
Rudberg	ルドバリ
Rudels	ルーデルス
Rudin	ルディーン
Ruhtenberg	ルーテンバリ
Rundback	ルンベック
Rundgren	ルンドグレーン
Rundkvist	ルンドクヴィスト
Rundquist	ルンドクヴィスト
Rundqvist	ルンドクヴィスト
Ruthström	ルトストレーム
Rybrant	リューブラント
Rydberg	リュードバリ
Rydholm	リドホルム
Saedén	セーデン
Sahlberg	サールバリ
Sahlén	サリアン
Sahlgren	サールグレーン
Sahlin	サリーン
Sahlström	サールストレーム
Samuelsson	サムエルソン
Sandahl	サンダール
Sandberg	サンドバリ
Sandborg	サンドボリ
Sandström	サンドストレーム
Santesson	サンテソン
Schjerven	シェルヴェン
Schönberg	シェーンバリ
Schymberg	シンバリ
Sedén	セデーン
Sederholm	セーデルホルム
Sedin	セディーン
Segelström	セーゲルストレーム
Segerstråle	セーゲルストローレ
Sejdelia	セイデリア
Selander	セランデル
Sellén	セリアン
Sibelius	シベリウス
Siegbahn	シーグバーン
Sigfridsson	ジグフリードソン
Silfverberg	シルフヴァルバリ
Silvmark	シルヴマルク
Simberg	シーンバリ
Sjöberg	フェーバリ
Sjöblom	フェーブロム
Sjöborg	フェーボリ
Sjöbring	フェーブリン
Sjödahl	フェーダール
Sjödin	フェーディーン
Sjögren	フェーグレーン
Sjöholm	フェーホルム
Sjölin	フェーリーン
Sjölund	フェールンド
Sjöstedt	フェーステット
Sjösten	フェーステーン
Sjöstrand	フェストランド
Sjöström	フェーストレーム
Skantze	スカンツェ
Skarsgård	スカーシュゴード
Skoglund	スコグルンド
Sköld	フェルド
Slättegård	スレッテゴード
Söderbaum	セーデルバウム
Söderberg	セーデルバリ
Söderblom	セーデルブロム
Söderborg	セーデルボリ
Södergren	セーデルグレーン
Söderholm	セーデルホルム
Söderkvist	セーデルクヴィスト
Söderlind	セーデルリンド
Söderlund	セーデルルンド
Söderlundh	セーデルルンド
Söderman	セーデルマン
Söderquist	セーデルクヴィスト
Söderqvist	セーデルクヴィスト
Södersten	セーデシュテーン
Söderström	セーデシュトレーム
Solander	ソランデル
Sönnerstadt	センナーシュタット
Sörenson	ソレンソン
Sörenstam	ソレンスタム
Staern	シュテルン
Ståhl	ストール
Ståhlberg	ストールバリ
Stål	ストール
Steen	ステーン
Stenhammar	ステーンハンマル
Stenholm	ステンホルム
Stenius	ステニウス
Stenmark	ステンマルク
Stenström	ステンストレーム
Stevenson	ステヴェンソン
Stigson	スティグソン
Stjernberg	ファルンバリ
Stjernkvist	ファーンクヴィスト
Stjernquist	ファーンクヴィスト
Stjernqvist	ファーンクヴィスト
Stockmann	ストークマン
Stoor	ストール
Strand	ストランド
Strandberg	ストランドバリ
Strandlind	ストランドリンド
Strandman	ストランドマン
Strindberg	ストリンドバリ、ストリンドベリ
Ström	ストレーム
Strömberg	ストレームバリ
Strömblad	ストレムブラード
Strömholm	ストレームホルム
Strömstedt	ストレームステット
Styrbjörn	ステュルビョルン
Sund	スンド
Sundberg	スンドバリ
Sundgren	スンドグレーン
Sundkvist	スンドクヴィスト
Sundquist	スンドクヴィスト
Sundqvist	スンドクヴィスト
Sundström	スンドストレーム
Sundvall	スンドヴァル
Suovanen	スオヴァネン
Svalberg	スヴァールバリ
Svanberg	スヴァンバリ
Svanholm	スヴァンホルム
Svanström	スヴァンストレーム
Svantesson	スヴァンテソン
Svärd	スヴァルド
Svartholm	スヴァルトホルム
Svedberg	スヴェードバリ
Svedbom	スヴェドボム
Svedlund	スヴェードルンド
Svendén	スヴェンデン
Svenonius	スヴェノニウス
Svensson	スヴェンソン
Svenstedt	スヴェンステット
Svenungsson	スヴェヌングソン
Svinhufvud	スヴィンフーフヴッド
Swedborg	スヴェドボリ
Swedenborg	スヴェーデンボリ
Syrén	スリアン、スレン
Tallkvist	タールクヴィスト
Tallqvist	タールクヴィスト
Tapper	タッペル
Taube	タウベ
Tegnér	テグネール
Tengström	テングストレーム
Terfelt	タールフェルト
Thalén	タリアン
Theorell	テオレル
Theorin	テオリーン
Thern	テルン
Thorborg	トールボリ
Thordendal	トーデンダル
Thorén	トリアン（トーレン）
Thors	トーシュ
Thunberg	トゥーンバリ
Thuresson	トゥーレソン
Thyrestam	ティレスタム
Tiselius	ティセリウス
Tjellqvist	シェルクヴィスト
Tjellström	シェルストレーム
Tjernberg	シャーンバリ
Tonemar	トーネマール
Torling	トールリン
Törnblom	トルンブロム
Törnell	トルネル
Törngren	トルングレーン
Törnkvist	トルンクヴィスト
Törnquist	トルンクヴィスト
Törnqvist	トルンクヴィスト
Törnros	トルンロース
Torstensson	トルステンソン
Udden	ウデーン
Uddenberg	ウッデンバリ
Ullman	ウルマン
Valkare	ヴァルカーレ
Vallgårda	ヴァルゴーダ
Vennberg	ヴェンバリ
Vennervik	ヴェンネルヴィク
Vesal	ヴェサール
Vestlund	ヴェストルンド
Vikander	ヴィカンデル
Viklund	ヴィクルンド
Vikström	ヴィクストレーム
Vinkvist	ヴィンクヴィスト
Vinquist	ヴィンクヴィスト
Vinqvist	ヴィンクヴィスト
Vretblad	ヴレットブラード
Wachtmeister	ヴァクトマイステル
Wadensjö	ヴァーデンフェ
Wadström	ヴァドストレーム
Wåhlander	ヴォーランデル
Wahlgren	ヴァールグレーン
Wåhlin	ヴォーリーン
Wahlström	ヴァールストレーム
Waldegård	ヴァルデゴード
Waldenström	ヴァルデンストレーム
Waldner	ヴァルドネル
Walin	ヴァリーン
Wallander	ヴァランデル
Wallén	ヴァリアン
Wallenius	ヴァレニウス
Wallenquist	ヴァレンクヴィスト
Wallenqvist	ヴァレンクヴィスト
Wallin	ヴァリーン
Wallström	ヴァルストレーム
Warg	ヴァリ
Wassberg	ヴァッスバリ
Wästfelt	ヴェストフェルト
Weckström	ヴェックストレーム
Welander	ヴェランデル
Welin	ヴェリーン
Wellander	ヴェランデル
Wellin	ヴェリーン
Wennberg	ヴェンバリ
Wennerberg	ヴェンネルバリ
Wennerström	ヴェンナシュトレーム
Wernbloom	ヴァルンブローム
Wesström	ヴェストレーム
Westberg	ヴェストバリ
Westerberg	ヴェステルバリ
Westerdahl	ヴェステルダール
Westergren	ヴェステルグレーン
Westerholm	ヴェステルホルム
Westerlund	ヴェステルンド
Westermarck	ヴェステルマルク
Westin	ヴェスティーン
Westling	ヴェストリン
Wettergren	ヴェッターグレーン
Wetterstrand	ヴェッタシュトランド
Wiberg	ヴィーバリ
Wibergh	ヴィーベリ
Wicksell	ヴィクセル
Wideen	ヴィデーン
Widegren	ヴィーデグレーン
Widén	ヴィデアン、ヴィデーン
Widing	ヴィーディン
Widstrand	ヴィードストランド
Widström	ヴィドストレーム
Wieselgren	ヴィーセルグレーン
Wijkander	ヴィーカンデル
Wikander	ヴィカンデル
Wikén	ヴィケーン、ヴィケアン
Wiklund	ヴィクルンド
Wikman	ヴィークマン
Wikström	ヴィークストレーム
Wilhelmsson	ヴィルヘルムソン
Winberg	ヴィンバリ
Wiren	ヴィレーン
Wistrand	ヴィストランド
Wkander	ヴィカンデル
Wohlfart	ヴォールファート
Wollgård	ヴォルゴード
Wretblad	ヴレットブラード
Ytterström	イッターシュトレーム
Zellbell	セルベル
Zetterberg	セッテルバリ
Zetterholm	セッテルホルム
Zetterlund	セッテルルンド
Ziedén	シーデーン