Aada	アーダ
Aamu	アーム
Ada	アダ
Aija	アイヤ
Aila	アイラ
Aili	アイリ
Aina	アイナ
Aini	アイニ
Ainikki	アイニッキ
Aino	アイノ
Aira	アイラ
Airi	アイリ
Aleksandra	アレクサンドラ
Aliisa	アリーサ
Alina	アリナ
Alisa	アリサ
Alli	アッリ
Alma	アルマ
Amalia	アマリア
Amanda	アマンダ
Anelma	アネルマ
Anita	アニタ
Anitta	アニッタ
Anja	アニヤ
Anna	アンナ
Anne	アンネ
Annele	アンネレ
Anneli	アンネリ
Anni	アンニ
Anniina	アンニーナ
Annika	アンニカ
Annikki	アンニッキ
Annukka	アンヌッカ
Ansa	アンサ
Antia	アンティア
Anu	アヌ
Arja	アルヤ
Armi	アルミ
Assi	アッシ
Asta	アスタ
Auli	アウリ
Aulikki	アウリッキ
Aune	アウネ
Auni	アウニ
Aura	アウラ
Auri	アウリ
Birgitta	ビルギッタ
Eeva	エーヴァ
Eevi	エーヴィ
Eija	エイヤ
Eila	エイラ
Eine	エイネ
Eini	エイニ
Eira	エイラ
Eleonoora	エレオノーラ
Eliina	エリーナ
Eliisa	エリーサ
Elina	エリナ
Elisa	エリサ
Elisabet	エリサベト
Ella	エッラ
Ellen	エッレン
Elli	エッリ
Elma	エルマ
Elmi	エルミ
Elna	エルナ
Elsa	エルサ
Else	エルセ
Elsi	エルシ
Elvi	エルヴィ
Emilia	エミリア
Emma	エンマ
Enni	エンニ
Erja	エルヤ
Essi	エッシ
Ester	エステル
Esteri	エステリ
Eveliina	エヴェリーナ
Fanni	ファンニ
Floora	フローラ
Hanna	ハンナ
Hannamari	ハンナマリ
Hanne	ハンネ
Hannele	ハンネレ
Heidi	ヘイディ
Heini	ヘイニ
Helena	ヘレナ
Helga	ヘルガ
Heli	ヘリ
Helinä	ヘリナ
Heljä	ヘリヤ
Helka	ヘルカ
Hellä	ヘッラ
Helle	ヘッレ
Hellevi	ヘッレヴィ
Helli	ヘッリ
Hellin	ヘッリン
Helmi	ヘルミ
Helvi	ヘルヴィ
Hely	ヘリュ
Henna	ヘンナ
Henni	ヘンニ
Henriikka	ヘンリーッカ
Hertta	ヘルッタ
Heta	ヘタ
Hilda	ヒルダ
Hilja	ヒリヤ
Hilkka	ヒルッカ
Hille	ヒッレ
Hillevi	ヒッレヴィ
Hilma	ヒルマ
Hilppa	ヒルッパ
Iida	イーダ
Iina	イーナ
Iines	イーネス
Iiris	イーリス
Ilma	イルマ
Ilmatar	イルマタル
Ilmi	イルミ
Ilona	イロナ
Ilta	イルタ
Immi	インミ
Impi	インピ
Inari	イナリ
Inka	インカ
Inkeri	インケリ
Inna	インナ
Ira	イラ
Irene	イレネ
Irina	イリナ
Irinja	イリニヤ
Irja	イルヤ
Irma	イルマ
Irmeli	イルメリ
Iro	イロ
Jaana	ヤーナ
Jelena	イェレナ
Jenna	イェンナ
Jenni	イェンニ
Johanna	ヨハンナ
Jonna	ヨンナ
Julia	ユリア
Juliana	ユリアナ
Justiina	ユスティーナ
Jutta	ユッタ
Juulia	ユーリア
Kaari	カーリ
Kaarina	カーリナ
Kaija	カイヤ
Kaino	カイノ
Kaisa	カイサ
Kaisu	カイス
Karita	カリタ
Karoliina	カロリーナ
Kastehelmi	カステヘルミ
Katariina	カタリーナ
Kati	カティ
Katja	カティヤ
Katri	カトリ
Katriina	カトリーナ
Kerttu	ケルットゥ
Kerttuli	ケルットゥリ
Kielo	キエロ
Kiia	キーア
Kiira	キーラ
Kirsi	キルシ
Kirsti	キルスティ
Klaara	クラーラ
Kreeta	クレータ
Krista	クリスタ
Kristiina	クリスティーナ
Kristina	クリスティナ
Kukka	クッカ
Kukka-Maaria	クッカ＝マーリア
Kylli	キュッリ
Kyllikki	キュッリッキ
Lahja	ラハヤ
Laila	ライラ
Laina	ライナ
Lauha	ラウハ
Laura	ラウラ
Lea	レア
Leea	レーア
Leena	レーナ
Leeni	レーニ
Leila	レイラ
Lemmikki	レンミッキ
Lempi	レンピ
Lenita	レニタ
Liia	リーア
Liina	リーナ
Liisa	リーサ
Liisi	リーシ
Lilja	リリヤ
Lilli	リッリ
Linnea	リンネア
Lotta	ロッタ
Loviisa	ロヴィーサ
Lyydia	リューディア
Lyyli	リューリ
Maaret	マーレト
Maaria	マーリア
Maarit	マーリト
Maija	マイヤ
Maiju	マイユ
Maikki	マイッキ
Maila	マイラ
Maili	マイリ
Mailis	マイリス
Maini	マイニ
Maire	マイレ
Maisa	マイサ
Manta	マンタ
Margareeta	マルガレータ
Mari	マリ
Maria	マリア
Mariaana	マリアーナ
Marianna	マリアンナ
Marianne	マリアンネ
Marika	マリカ
Marikka	マリッカ
Marita	マリタ
Maritta	マリッタ
Marja	マルヤ
Marjaana	マルヤーナ
Marjatta	マルヤッタ
Marjo	マルヨ
Marjukka	マルユッカ
Marjut	マルユト
Marketta	マルケッタ
Martta	マルッタ
Mataleena	マタレーナ
Matilda	マティルダ
Meeri	メーリ
Merja	メルヤ
Mervi	メルヴィ
Mielikki	ミエリッキ
Miia	ミーア
Miina	ミーナ
Miisa	ミーサ
Milja	ミリヤ
Milla	ミッラ
Mimmi	ミンミ
Minna	ミンナ
Mira	ミラ
Mirja	ミルヤ
Mirjami	ミルヤミ
Mirka	ミルカ
Mirkka	ミルッカ
Mirva	ミルヴァ
Niina	ニーナ
Nina	ニナ
Noora	ノーラ
Oili	オイリ
Oivi	オイヴィ
Olga	オルガ
Onerva	オネルヴァ
Orvokki	オルヴォッキ
Outi	オウティ
Päivä	パイヴァ
Päivi	パイヴィ
Päivikki	パイヴィッキ
Pälvi	パルヴィ
Paula	パウラ
Pauliina	パウリーナ
Petra	ペトラ
Piia	ピーア
Piritta	ピリッタ
Pirjo	ピルヨ
Pirkko	ピルッコ
Pulmu	プルム
Raakel	ラーケル
Raija	ライヤ
Raila	ライラ
Raili	ライリ
Raisa	ライサ
Raita	ライタ
Rauha	ラウハ
Rauna	ラウナ
Rauni	ラウニ
Rebekka	レベッカ
Reeta	レータ
Reetta	レーッタ
Reija	レイヤ
Riia	リーア
Riikka	リーッカ
Riina	リーナ
Riitta	リーッタ
Ritva	リトヴァ
Roine	ロイネ
Ronja	ロニヤ
Ruusu	ルース
Ruut	ルート
Saara	サーラ
Säde	サデ
Saija	サイヤ
Saila	サイラ
Saima	サイマ
Saimi	サイミ
Saini	サイニ
Salla	サッラ
Salli	サッリ
Salme	サルメ
Sandra	サンドラ
Sanelma	サネルマ
Sanna	サンナ
Sanni	サンニ
Sara	サラ
Sari	サリ
Satu	サトゥ
Seija	セイヤ
Selja	セリヤ
Selma	セルマ
Senja	セニヤ
Senni	センニ
Serafiina	セラフィーナ
Sesilia	セシリア
Signe	シグネ
Siiri	シーリ
Silja	シリヤ
Silva	シルヴァ
Sini	シニ
Sinikka	シニッカ
Sirkka	シルッカ
Sirkku	シルック
Sirpa	シルパ
Sisko	シスコ
Sivi	シヴィ
Sofia	ソフィア
Sohvi	ソホヴィ
Soila	ソイラ
Soile	ソイレ
Soili	ソイリ
Sointu	ソイントゥ
Solja	ソリヤ
Sonja	ソニヤ
Sorja	ソルヤ
Stiina	スティーナ
Suoma	スオマ
Suometar	スオメタル
Susanna	スサンナ
Suvi	スヴィ
Sylvi	シュルヴィ
Sylvia	シュルヴィア
Taija	タイヤ
Taimi	タイミ
Taina	タイナ
Talvikki	タルヴィッキ
Tanja	タニヤ
Tarja	タルヤ
Taru	タル
Tea	テア
Teija	テイヤ
Tellervo	テッレルヴォ
Teresa	テレサ
Terhi	テルヒ
Terhikki	テルヒッキ
Terttu	テルットゥ
Tiia	ティーア
Tiina	ティーナ
Tilda	ティルダ
Tinja	ティニヤ
Toini	トイニ
Tuija	トゥイヤ
Tuire	トゥイレ
Tuomi	トゥオミ
Tuovi	トゥオヴィ
Tuula	トゥーラ
Tuuli	トゥーリ
Tuulia	トゥーリア
Tuulikki	トゥーリッキ
Tyyne	テューネ
Tyyni	テューニ
Ulla	ウッラ
Ulpu	ウルプ
Ulriikka	ウルリーッカ
Unelma	ウネルマ
Ursula	ウルスラ
Valma	ヴァルマ
Valpuri	ヴァルプリ
Vanamo	ヴァナモ
Vappu	ヴァップ
Varma	ヴァルマ
Varpu	ヴァルプ
Vaula	ヴァウラ
Veera	ヴェーラ
Vellamo	ヴェッラモ
Venla	ヴェンラ
Verna	ヴェルナ
Viena	ヴィエナ
Vieno	ヴィエノ
Viivi	ヴィーヴィ
Vilhelmiina	ヴィルヘルミーナ
Vilja	ヴィリヤ
Vilma	ヴィルマ
Virpi	ヴィルピ
Virva	ヴィルヴァ
Virve	ヴィルヴェ
Vuokko	ヴオッコ