Ada	アーダ
Adalgisa	アダルジーザ
Addolorata	アッドロラータ
Adelaide	アデラーイデ
Adele	アデーレ
Adelina	アデリーナ
Adria	アドリア
Adriana	アドリアーナ
Agata	アガタ、アーガタ
Agnella	アニェッラ
Agnese	アニェーゼ
Agostina	アゴスティーナ
Aida	アイーダ
Alba	アールバ
Alberta	アルベルタ
Albertina	アルベルティーナ
Albina	アルビーナ
Alda	アルダ、アールダ
Alessandra	アレッサンドラ
Alessia	アレッシア
Alfonsina	アルフォンシーナ
Alfreda	アルフレーダ
Alice	アリーチェ
Alicia	アリーチャ
Alida	アリダ、アリーダ
Alina	アリーナ
Allegra	アッレーグラ
Alma	アルマ、アールマ
Altea	アルテーア
Amalia	アマーリア
Amanda	アマンダ
Amata	アマータ
Ambra	アンブラ
Amelia	アメリア、アメーリア
Amelita	アメリータ
Anastasia	アナスタージア
Anatolia	アナトリア、アナトーリア
Andreina	アンドレイーナ
Angela	アンジェラ
Angelica	アンジェリカ、アンジェーリカ
Angelina	アンジェリーナ
Angiola	アンジョラ
Angioletta	アンジョレッタ
Anita	アニータ
Anna	アンナ
Annabella	アンナベッラ
Annalisa	アンナリーザ
Annamaria	アンナマリア、アンナマリーア
Annetta	アンネッタ
Annunziata	アンヌンツィアータ
Antonella	アントネッラ
Antonia	アントーニア
Antonietta	アントニエッタ
Antonina	アントニーナ
Arabella	アラベッラ
Arianna	アリアンナ
Asia	アージア
Assunta	アッスンタ
Augusta	アウグスタ
Aurelia	アウレーリア
Aureliana	アウレリアーナ
Aurora	アウローラ
Ave	アーヴェ
Azzurra	アッズーラ
Bambina	バンビーナ
Barbara	バルバラ、バールバラ
Bartolomea	バルトロメア
Basilia	バジーリア
Beata	ベアータ
Beatrice	ベアトリーチェ
Bella	ベッラ
Benedetta	ベネデッタ
Beniamina	ベニアミーナ
Benvenuta	ベンヴェヌータ
Berenice	ベレニーチェ
Bernadetta	ベルナデッタ
Bernardetta	ベルナルデッタ
Berta	ベルタ
Bertina	ベルティーナ
Betta	ベッタ
Bettina	ベッティーナ
Bianca	ビアンカ
Bibiana	ビビアナ、ビビアーナ
Bice	ビーチェ
Bionda	ビオンダ
Bona	ボーナ
Brigida	ブリージダ
Brigitta	ブリジッタ
Bruna	ブルーナ
Brunella	ブルネッラ
Brunilda	ブルニルダ
Camelia	カメーリア
Camilla	カミッラ
Candida	カンディダ
Cara	カーラ
Carina	カリーナ
Carla	カールラ
Carlotta	カルロッタ
Carmela	カルメーラ
Carmen	カルメン
Carola	カローラ
Carolina	カロリーナ
Cassandra	カッサンドラ
Catarina	カタリーナ
Catena	カテーナ
Caterina	カテリーナ
Cecilia	チェチーリア
Celeste	チェレステ
Celestina	チェレスティーナ
Celia	チェーリア
Chiara	キアーラ
Cinzia	チンツィア
Clara	クラーラ
Clarice	クラリーチェ
Clarissa	クラリッサ
Claudia	クラウディア
Clelia	クレリア、クレーリア
Clementina	クレメンティーナ
Cleo	クレオ
Cleopatra	クレオパトラ、クレオパートラ
Cloe	クローエ
Clorinda	クロリンダ
Colomba	コロンバ
Concetta	コンチェッタ
Consilia	コンシリア
Consolata	コンソラータ
Cornelia	コルネリア、コルネーリア
Cosima	コジマ、コージマ
Cosma	コズマ、コーズマ
Costanza	コスタンツァ
Cristiana	クリスティアーナ
Cristina	クリスティーナ
Dacia	ダーチャ
Dafne	ダフネ
Dalida	ダリダ
Dalila	ダリラ
Daniela	ダニエラ
Daria	ダリア、ダーリア
Debora	デボラ
Delfina	デルフィーナ
Delia	デーリア
Delizia	デリツィア
Demetria	デメトリア
Desideria	デジデリア、デジデーリア
Diamante	ディアマンテ
Diana	ディアナ、ディアーナ
Dina	ディーナ
Dionisia	ディオニージア
Domenica	ドメニカ、ドメーニカ
Domitilla	ドミティッラ
Domiziana	ドミツィアナ
Donata	ドナータ
Donatella	ドナテッラ
Dorotea	ドロテーア
Ebe	エーベ
Edda	エッダ
Editta	エディッタ
Edmonda	エドモンダ
Edvige	エドヴィージェ
Elda	エルダ
Elena	エレナ
Eleonora	エレオノーラ
Elettra	エレットラ
Eliana	エリアナ、エリアーナ
Elide	エリデ
Elisa	エリーザ
Elisabetta	エリザベッタ
Ella	エッラ
Elma	エルマ
Eloisa	エロイーザ
Elsa	エルサ
Elvira	エルヴィーラ
Emanuela	エマヌエーラ
Emilia	エミーリア、エミリア
Emiliana	エミリアーナ
Emma	エンマ
Enrica	エンリカ、エンリーカ
Ermelinda	エルメリンダ
Erminia	エルミーニア
Ernesta	エルネスタ
Ersilia	エルシーリア
Esmeralda	エズメラルダ
Estella	エステッラ
Eufemia	エウフェミア
Eufrasia	エウフラージア
Eugenia	エウジェニア、エウジェーニア
Eulalia	エウラリア、エウラーリア
Eva	エヴァ、エーヴァ
Evangelina	エヴァンジェリーナ
Evelina	エヴェリーナ
Fabia	ファビア
Fabiana	ファビアーナ
Fabiola	ファビオラ
Fabrizia	ファブリツィア
Faustina	ファウスティーナ
Federica	フェデリーカ
Fedora	フェドーラ
Felicia	フェリーチャ
Feliciana	フェリチャーナ
Felicita	フェリチタ
Ferdinanda	フェルディナンダ
Fernanda	フェルナンダ
Fiamma	フィアンマ
Fiammetta	フィアンメッタ
Filippa	フィリッパ
Filomena	フィロメーナ
Fiore	フィオレ
Fiorella	フィオレッラ
Fiorentina	フィオレンティーナ
Fiorenza	フィオレンツァ
Fiorina	フィオリーナ
Flaminia	フラミニア、フラミーニア
Flavia	フラヴィア、フラーヴィア
Flaviana	フラヴィアーナ
Flora	フローラ
Floriana	フロリアーナ、フロリアナ
Fortunata	フォルトゥナータ
Franca	フランカ
Francesca	フランチェスカ
Fulvia	フルヴィア
Gabriella	ガブリエッラ
Gaia	ガイア
Gelsomina	ジェルソミーナ
Geltrude	ジェルトルデ
Gemma	ジェンマ
Genoveffa	ジェノヴェッファ
Geraldina	ジェラルディーナ
Gertrude	ジェルトルーデ
Giacinta	ジャチンタ
Giada	ジャーダ
Gianna	ジャンナ
Gigliola	ジリオーラ、ジッリョーラ
Gilberta	ジルベルタ
Gilda	ジルダ
Giliola	ジリオーラ
Gina	ジーナ
Ginevra	ジネーヴラ
Gioconda	ジョコンダ
Gioia	ジョイア
Giorgia	ジョルジャ
Giorgina	ジョルジーナ
Giovanna	ジョヴァンナ
Gisella	ジゼッラ
Giuditta	ジュディッタ
Giulia	ジュリア、ジューリア
Giuliamaria	ジュリアマリア、ジュリアマリーア
Giuliana	ジュリアーナ
Giulietta	ジュリエッタ
Giuseppa	ジュゼッパ
Giuseppina	ジュゼッピーナ
Giusta	ジュスタ
Giustina	ジュスティーナ
Gloria	グローリア
Grazia	グラツィア、グラッツィア
Graziana	グラツィアーナ
Graziella	グラツィエッラ
Greta	グレータ、グレタ
Griselda	グリゼルダ
Idea	イデア
Ilaria	イラーリア
Ilda	イルダ
Ilenia	イレーニア
Ilva	イルヴァ
Imelda	イメルダ
Immacolata	インマコラータ
Innocenza	インノチェンツァ
Iolanda	イオランダ、ヨランダ
Ippolita	イッポリタ、イッポーリタ
Irene	イレーネ
Irma	イルマ
Isabella	イザベッラ（イザベラ）
Isotta	イゾッタ
Itala	イタラ、イータラ
Italia	イターリア
Ivetta	イヴェッタ
Jolanda	ヨランダ
Katia	カーティア
Lara	ラーラ
Laura	ラウラ
Lauretta	ラウレッタ
Lavinia	ラヴィニア、ラヴィーニア
Lea	レーア
Leda	レーダ
Lena	レーナ
Leontina	レオンティーナ
Letizia	レティツィア、レティーツィア
Lia	リア、リーア
Liberata	リベラータ
Licia	リーチャ
Lidia	リディア、リーディア
Liliana	リリアーナ
Linda	リンダ
Lionella	リオネッラ
Lisa	リーザ
Livia	リヴィア、リーヴィア
Loredana	ロレダーナ
Lorella	ロレッラ
Lorena	ロレーナ
Lorenza	ロレンツァ
Loretta	ロレッタ
Luana	ルアーナ
Luce	ルーチェ
Lucia	ルチア
Luciana	ルチャーナ
Lucilla	ルチッラ
Lucrezia	ルクレツィア
Ludovica	ルドヴィカ、ルドヴィーカ
Luigia	ルイージャ
Luisa	ルイーザ
Luna	ルーナ
Maddalena	マッダレーナ
Mafalda	マファルダ
Magda	マグダ
Manuela	マヌエーラ
Mara	マーラ
Marcella	マルチェッラ
Marcellina	マルチェッリーナ
Margherita	マルゲリータ
Maria	マリア、マリーア
Mariana	マリアーナ
Mariangela	マリアンジェラ
Marianna	マリアンナ
Marica	マリカ
Mariella	マリエッラ
Marietta	マリエッタ
Marilena	マリレーナ
Marina	マリーナ
Marinella	マリネッラ
Marinetta	マリネッタ
Marisa	マリーザ
Marta	マルタ
Martina	マルティーナ
Marzia	マルツィア
Massima	マッシマ
Matilde	マティルデ
Maura	マウラ
Melania	メラーニア
Melissa	メリッサ
Mercede	メルチェーデ
Michela	ミケーラ
Mila	ミーラ
Milena	ミレーナ
Mina	ミーナ
Minerva	ミネルヴァ
Mirella	ミレッラ
Miriam	ミリアム
Modesta	モデスタ
Monica	モニカ
Morena	モレーナ
Morgana	モルガーナ
Nadia	ナーディア
Natalia	ナタリア
Natalina	ナタリーナ
Nerea	ネレーア
Nerina	ネリーナ
Nicla	ニクラ
Nicoletta	ニコレッタ
Nilde	ニルデ
Nina	ニナ、ニーナ
Ninfa	ニンファ
Nives	ニヴェス、ニーヴェス
Noemi	ノエミ
Nora	ノーラ
Norma	ノルマ
Novella	ノヴェッラ
Nunzia	ヌンツィア
Odetta	オデッタ
Ofelia	オフェーリア
Olga	オルガ
Olimpia	オリンピア
Olivia	オリーヴィア
Oliviera	オリヴィエラ
Ombretta	オンブレッタ
Ondina	オンディーナ
Onesta	オネスタ
Orestilla	オレスティッラ
Oriana	オリアーナ
Orietta	オリエッタ
Ornella	オルネッラ
Ortensia	オルテンシア
Osanna	オザンナ
Ottavia	オッタヴィア
Ottilia	オッティーリア
Pamela	パメラ
Paola	パオラ
Paolina	パオリーナ
Patrizia	パトリツィア
Penelope	ペネロペ
Perla	ペルラ、ペールラ
Petronilla	ペートロニッラ
Pia	ピア、ピーア
Piera	ピエラ
Pierina	ピエリーナ
Priscilla	プリシッラ
Rachele	ラケーレ
Raffaella	ラファエラ、ラッファエッラ
Rebecca	レベッカ
Regina	レジーナ
Renata	レナータ
Riccarda	リッカルダ
Rita	リータ
Roberta	ロベルタ
Romana	ロマーナ
Romilda	ロミルダ
Romina	ロミーナ
Rosa	ローザ
Rosalia	ロザリア
Rosalinda	ロザリンダ
Rosanna	ロザンナ
Rosetta	ロゼッタ
Rosita	ロジータ
Rossana	ロッサーナ
Rossella	ロッセッラ
Rufina	ルフィナ
Saba	サーバ
Sabina	サビーナ
Sabrina	サブリーナ
Samanta	サマンタ
Samantha	サマンタ
Sandra	サンドラ
Sara	サーラ
Seconda	セコンダ
Secondina	セコンディーナ
Selene	セレーネ
Serafina	セラフィーナ
Serena	セレーナ
Severa	セヴェーラ
Sibilla	シビッラ
Silvana	シルヴァーナ
Silvia	シルヴィア
Simona	シモーナ
Simonetta	シモネッタ
Sofia	ソフィア、ソフィーア
Sonia	ソニア、ソーニア
Stefania	ステファニア、ステファーニア
Stella	ステッラ
Susanna	スザンナ
Sveva	ズヴェーヴァ
Tamara	タマーラ
Tarquinia	タルクウィニア
Tea	テーア
Tecla	テクラ
Teodora	テオドーラ
Teofila	テオフィラ
Teresa	テレーザ
Tina	ティーナ
Tiziana	ティツィアーナ
Tosca	トスカ
Tullia	トゥッリア、トゥーリア
Valentina	ヴァレンティーナ
Valeria	ヴァレーリア
Valeriana	ヴァレリアナ、ヴァレリアーナ
Vanda	ヴァンダ
Vanessa	ヴァネッサ
Vanna	ヴァンナ
Veneranda	ヴェネランダ
Vera	ヴェーラ、ヴェラ
Verdiana	ヴェルディアナ
Veronica	ヴェロニカ
Vincenza	ヴィンチェンツァ
Viola	ヴィオラ
Violante	ヴィオランテ
Violetta	ヴィオレッタ
Virginia	ヴィルジニア、ヴィルジーニア
Vittoria	ヴィットーリア
Viviana	ヴィヴィアーナ
Wanda	ヴァンダ
Zaira	ザイラ
Zita	ジータ
Zoe	ゾーエ