Abel	アーベル
Abraham	アーブラハム
Achim	アヒム
Adalbert	アーダルベルト
Adalbrecht	アダルブレヒト
Adam	アーダム、アダム
Adelbert	アーデルベルト
Adolf	アードルフ
Adrian	アードリアン
Alban	アルバン
Albert	アルベルト
Albrecht	アルブレヒト
Alexander	アレクサンダー
Alexis	アレクシス
Alfons	アルフォンス
Alfred	アルフレート
Alois	アロイス、アーロイス
Aloisius	アロイジウス
Aloys	アロイス
Aloysius	アロイジウス
Anastasius	アナスタージウス
Andreas	アンドレアス
Anselm	アンゼルム
Ansgar	アンスガー
Anton	アントン、アントーン
Armin	アルミン
Arno	アルノー
Arnold	アルノルト
Arnolt	アルノルト
Arnulf	アルヌルフ
Arthur	アルトゥル、アルトゥール
Artur	アルトゥル、アルトゥール
August	アウグスト
Augustin	アウグスティーン
Aurel	アウレール
Balduin	バルドゥイーン
Baldur	バルドゥル
Balthasar	バルタザール
Baptist	バプティスト
Barnabas	バルナバス
Barthold	バルトルト
Bartholomäus	バルトロメウス
Benedikt	ベネディクト、ベーネディクト
Benjamin	ベンヤミン
Benno	ベンノ
Bernd	ベルント
Bernhard	ベルンハルト
Bernold	ベルノルト
Berthold	ベルトホルト、ベルトルト
Bonifatius	ボニファティウス
Bonifaz	ボニファーツ
Bruno	ブルーノ
Burghard	ブルクハルト
Burkhard	ブルクハルト
Carl	カール
Cäsar	ツェーザル
Caspar	カスパル、カスパー
Christhard	クリストハルト
Christian	クリスティアン
Christof	クリストフ
Christoph	クリストフ
Claus	クラウス
Clemens	クレーメンス
Conrad	コンラート
Cornelius	コルネリウス
Curt	クルト
Damian	ダミアン
Daniel	ダニエル
David	ダーヴィト、ダーフィト
Denis	デニス
Dennis	デニス
Diederich	ディーデリヒ
Dieter	ディーター
Dietfried	ディートフリート
Diethard	ディートハルト
Diethelm	ディートヘルム
Dietmar	ディートマー、ディートマル
Dietrich	ディートリヒ
Dirk	ディルク
Dominik	ドミニク
Ebbo	エッボ
Eberhard	エーベルハルト
Eckard	エッカルト
Eckardt	エッカルト
Eckart	エッカルト
Eckhard	エックハルト
Edeltraud	エーデルトラウト
Edgar	エトガル、エトガー
Edmund	エトムント
Eduard	エードゥアルト、エドゥアルト
Edwin	エトヴィン
Egmont	エグモント
Egmund	エクムント
Egon	エーゴン、エゴン
Ehrenfried	エーレンフリート
Ekkehard	エッケハルト
Elias	エリーアス
Elmar	エルマー
Emanuel	エマーヌエル、エマヌエル
Emil	エーミール
Emmerich	エメリヒ
Engelbert	エンゲルベルト
Engelbrecht	エンゲルブレヒト
Erhard	エアハルト
Erich	エーリヒ
Erik	エーリク、エーリック
Ernst	エルンスト
Erwin	エルヴィン
Eugen	オイゲン
Ewald	エーヴァルト
Fabian	ファビアン
Felix	フェリクス
Ferdinand	フェルディナント
Filibert	フィリベルト
Florenz	フロレンツ
Florian	フローリアーン、フロリアン
Frank	フランク
Franz	フランツ
Friedhelm	フリートヘルム
Friedrich	フリードリヒ
Fritz	フリッツ
Fürchtegott	フュルヒテゴット
Gabriel	ガーブリエル、ガーブリエール
Gebhard	ゲープハルト
Georg	ゲオルク
Gerald	ゲラルト
Gerd	ゲルト
Gereon	ゲレオン
Gerhard	ゲーアハルト（ゲルハルト）
Gerhardt	ゲーアハルト
Gerhart	ゲーアハルト
Gernot	ゲーアノート
Gerold	ゲロルト、ゲーロルト
Gert	ゲルト、ゲアト
Gerulf	ゲルルフ
Gilbert	ギルベルト
Gottfried	ゴットフリート
Gotthard	ゴットハルト
Gotthelff	ゴットヘルフ
Gotthold	ゴットホルト
Gottlieb	ゴットリープ
Gottlob	ゴットロープ
Götz	ゲッツ
Gregor	グレーゴール、グレーゴーア
Guido	ギード
Günter	ギュンター
Gunter	グンター
Gunther	グンター
Günther	ギュンター
Gustaf	グスタフ
Gustav	グスタフ
Hagen	ハーゲン
Hannes	ハンネス
Hanns	ハンス
Hans	ハンス
Harald	ハーラルト
Harold	ハーロルト
Hartmut	ハルトムート
Hartwig	ハルトヴィヒ
Hartwin	ハルトヴィン
Heimo	ハイモ
Heino	ハイノ
Heinrich	ハインリヒ
Heinz	ハインツ
Helfried	ヘルフリート
Helge	ヘルゲ
Hellmut	ヘルムート
Hellmuth	ヘルムート
Helmfried	ヘルムフリート
Helmut	ヘルムート
Helmuth	ヘルムート
Hendrik	ヘンドリック
Henrik	ヘンリック
Herbert	ヘルベルト
Hermann	ヘルマン
Hieronymus	ヒエロニムス
Hildebert	ヒルデベルト
Hildebrand	ヒルデブラント
Hildebrecht	ヒルデブレヒト
Holger	ホルガー
Horaz	ホラーツ
Horst	ホルスト
Hubert	フーベルト
Hubertus	フーベルトゥス
Hugo	フーゴ
Humbert	フンベルト
Ignaz	イグナーツ
Immanuel	イマーヌエル、イマヌエル
Ingo	インゴ
Ingolf	インゴルフ
Isaak	イザーク
Isidor	イージドール、イージドーア
Ivo	イーヴォ
Jacob	ヤーコプ
Jakob	ヤーコプ
Jan	ヤン
Jeremias	イェレミアス
Joachim	ヨアヒム、ヨーアヒム
Jochem	ヨッヘム
Johann	ヨハン
Johannes	ヨハンネス、ヨハネス
Jonas	ヨーナス
Jonathan	ヨナタン
Jordan	ヨルダン
Jörg	イェルク、ヨルク
Jörn	イェルン、ヨルン
Josef	ヨーゼフ
Joseph	ヨーゼフ
Julian	ユリアン
Julius	ユーリウス、ユリウス
Jürgen	ユルゲン
Justus	ユストゥス
Kai	カイ
Kamil	カミル
Karl	カール
Karlheinz	カールハインツ
Karsten	カルステン、カーステン
Kaspar	カスパル、カスパー
Kevin	ケヴィン
Klaus	クラウス
Klemens	クレーメンス
Knut	クヌート
Konrad	コンラート
Konradin	コンラーディン
Konstantin	コンスタンティン
Kunz	クンツ
Kurt	クルト
Lambert	ランベルト
Lamprecht	ランプレヒト
Lars	ラルス、ラース
Laurenz	ラウレンツ
Leo	レオ
Leon	レオン
Leonard	レオナルト
Leonhard	レオンハルト
Leopold	レオポルト、レーオポルト
Lienhard	リーンハルト
Linus	リーヌス
Lorenz	ローレンツ
Lothar	ロータル
Ludger	ルートガー、ルトガー
Ludolf	ルードルフ
Ludwig	ルートヴィヒ
Luitpold	ルイトポルト
Lukas	ルーカス
Lutz	ルッツ
Manfred	マンフレート
Manuel	マヌエル
Marcel	マルセル
Marco	マルコ
Marcus	マルクス
Marian	マリアン
Marius	マリウス
Mark	マルク
Markus	マルクス
Martin	マルティン、マルティーン
Mathias	マティーアス、マティアス
Matthäus	マテーウス
Matthias	マティーアス
Max	マックス
Maximilian	マクシミリアン
Meinrad	マインラート
Melchior	メルヒオール、メルヒオーア
Michael	ミヒャエル
Michel	ミヒェル
Moritz	モーリッツ
Moriz	モーリッツ
Nathan	ナータン
Nathanael	ナターナエル
Nepomuk	ネーポムク
Niklas	ニクラス
Niklaus	ニクラウス
Nikolaus	ニコラウス
Norbert	ノルベルト、ノアベルト
Olaf	オーラフ
Oliver	オリヴァー
Oscar	オスカー
Oskar	オスカー
Oswald	オスヴァルト
Oswin	オスヴィン
Otmar	オットマー
Ottmar	オットマー
Otto	オットー
Ottomar	オットマー
Pascal	パスカル
Patrick	パトリック
Paul	パウル
Peter	ペーター
Petrus	ペートルス
Philipp	フィリップ
Rafael	ラファエル
Raimund	ライムント
Rainald	ライナルト
Rainer	ライナー
Ralf	ラルフ
Ralph	ラルフ
Randolf	ランドルフ
Raphael	ラファエル
Reimar	ライマー
Reimund	ライムント
Reinald	ライナルト
Reiner	ライナー
Reinhard	ラインハルト
Reinhold	ラインホルト
Reinmar	ラインマー
Richard	リヒャルト
Robert	ローベルト
Rochus	ロホス、ロッホス
Roderich	ローデリヒ
Roland	ローラント
Rolf	ロルフ
Roman	ローマン
Rüdiger	リュディガー
Rudolf	ルードルフ、ルドルフ
Rupert	ルーペルト
Ruprecht	ループレヒト
Samuel	ザームエル
Sascha	ザシャ
Sebastian	ゼバスティアン、ゼバスチャン
Siegbert	ジークベルト
Siegfried	ジークフリート
Sieghard	ジークハルト
Siegmund	ジークムント
Siegward	ジークヴァルト
Sigismund	ジギスムント
Sigiswald	ジギスヴァルト
Sigmund	ジークムント
Silvester	ジルヴェスター
Simon	ジーモン
Stefan	シュテファン
Stephan	シュテファン
Sven	スヴェン
Theo	テオ
Theobald	テオバルト
Theodor	テオドール、テーオドーア
Theophil	テオフィル
Thomas	トーマス
Timo	ティモ
Tobias	トビアス
Traugott	トラウゴット
Udo	ウド
Ulrich	ウルリヒ
Utz	ウッツ
Uwe	ウーヴェ
Valentin	ヴァレンティーン
Veit	ファイト
Viktor	ヴィクトール、ヴィクトア
Vincenz	ヴィンツェンツ
Vinzenz	ヴィンツェンツ
Volker	フォルカー
Volkhard	フォルクハルト
Volkmar	フォルクマー
Waldemar	ヴァルデマール、ヴァルデマー
Walter	ヴァルター
Walther	ヴァルター
Wendel	ヴェンデル
Wendelin	ヴェンデリン
Wenzel	ヴェンツェル
Werner	ヴェルナー
Wernher	ヴェルナー
Wieland	ヴィーラント
Wilfried	ヴィルフリート
Wilhelm	ヴィルヘルム
Willi	ヴィリ
Willibald	ヴィリバルト
Willy	ヴィリー
Wilmar	ヴィルマー
Wim	ヴィム
Winfried	ヴィンフリート
Woldemar	ヴォルデマール、ヴォルデマー
Wolf	ヴォルフ
Wolfgang	ヴォルフガング
Wolfram	ヴォルフラム
Xaver	クサーヴァー
Yvo	イーヴォ