Abbondio	アッボンディオ
Abelardo	アベラルド
Abele	アベーレ
Abramo	アブラーモ
Achille	アキッレ
Achilleo	アキッレーオ
Adalberto	アダルベルト
Adamo	アダーモ
Adelmo	アデルモ
Adolfo	アドルフォ
Adriano	アドリアーノ
Agnello	アニェッロ
Agnolo	アニョロ、アンニョロ
Agostino	アゴスティーノ
Albano	アルバーノ
Alberto	アルベールト
Alcide	アルチーデ、アルチデ
Aldo	アルド、アールド
Alessandro	アレッサンドロ
Alessio	アレッシオ
Alfio	アルフィオ
Alfonso	アルフォンソ
Alfredo	アルフレード
Alicio	アリーチョ
Almiro	アルミロ
Aloisio	アロイージオ
Alonzo	アロンツォ
Alvaro	アルヴァロ、アルヴァーロ
Amadeo	アマデオ
Amato	アマート
Ambrogio	アンブロージョ
Amedeo	アメデオ
Amerigo	アメリーゴ
Amilcare	アミールカレ
Amintore	アミントレ
Anacleto	アナクレート
Anastasio	アナスタージオ、アナスターシオ
Andrea	アンドレーア
Angelo	アンジェロ
Angiolino	アンジョリーノ
Aniceto	アニチェート
Aniello	アニエッロ
Annibale	アンニーバレ
Anselmo	アンセルモ、アンセールモ
Antioco	アンティオコ
Antonello	アントネッロ
Antonino	アントニーノ
Antonio	アントーニオ
Apollinare	アポリナーレ
Arcangelo	アルカンジェロ
Arcibaldo	アルチバルド
Arduino	アルドゥイノ
Armando	アルマンド
Arnaldo	アルナルド
Arnoldo	アルノルド
Aroldo	アロルド
Arrigo	アルリーゴ
Arturo	アルトゥーロ
Assunto	アッスント
Attilio	アッティーリオ
Augustino	アウグスティーノ
Augusto	アウグスト
Aureliano	アウレリアーノ
Aurelio	アウレーリオ
Ausilio	アウジリオ
Baldassare	バルダッサーレ
Baldassarre	バルダッサーレ
Baldo	バルド
Baldovino	バルドヴィーノ
Barnaba	バルナバ
Bartolo	バルトロ
Bartolomeo	バルトロメーオ
Bartolommeo	バルトロメーオ
Basilio	バジーリオ
Battista	バッティスタ
Belisario	ベリザリオ、ベリザーリオ
Benedetto	ベネデット
Beniamino	ベニャミーノ、ベニアミーノ
Benigno	ベニーニョ
Benito	ベニート
Benvenuto	ベンヴェヌート
Bernardino	ベルナルディーノ
Bernardo	ベルナルド、ベルナールド
Bertoldo	ベルトルド
Bertrando	ベルトランド
Biaggio	ビアッジョ
Biagio	ビアージョ
Bonaventura	ボナヴェントゥーラ
Bonifacio	ボニファーチョ
Bonifazio	ボニファーツィオ
Bonito	ボニート
Brizio	ブリツィオ、ブリーツィオ
Bruno	ブルーノ
Callisto	カッリスト
Calogero	カロージェロ
Camillo	カミッロ
Carlo	カルロ
Carmelo	カルメーロ
Carmine	カルミネ、カールミネ
Casto	カスト
Catullo	カトゥッロ
Cecilio	チェチーリオ
Celestino	チェレスティーノ
Celio	チェーリオ
Celso	チェルソ
Cesare	チェーザレ
Cesarino	チェザリーノ
Chiaffredo	キアッフレード
Cipriano	チプリアーノ
Ciriaco	チリアーコ
Cirillo	チリッロ
Cirino	チリーノ
Ciro	チーロ
Claudio	クラウディオ
Clemente	クレメンテ
Cleto	クレート
Columbano	コルンバーノ
Cornelio	コルネリオ、コルネーリオ
Corradino	コッラディーノ
Corrado	コルラード
Cosimo	コジモ、コージモ
Cosmo	コズモ、コーズモ
Costantino	コスタンティーノ
Costanzo	コスタンツォ
Crescenzio	クレシェンツィオ
Crispino	クリスピーノ
Cristiano	クリスティアーノ
Cristoforo	クリストフォロ
Dalmazio	ダルマツィオ、ダルマーツィオ
Damiano	ダミアーノ
Daniele	ダニエーレ
Danilo	ダニロ
Danio	ダニオ
Dante	ダンテ
Dario	ダリオ、ダーリオ
David	ダヴィード
Davide	ダヴィデ、ダーヴィデ
Decimo	デチモ
Delfino	デルフィーノ
Demetrio	デメトリオ、デメートリオ
Desiderio	デジデリオ、デジデーリオ
Dino	ディーノ
Dionigi	ディオニージ
Domenico	ドメニコ
Domiziano	ドミツィアーノ
Donatello	ドナテッロ
Donato	ドナート
Duccio	ドゥッチョ
Duilio	ドゥイリオ
Edgardo	エドガルド、エドガールド
Edmondo	エドモンド
Edoardo	エドアルド
Efisio	エフィジオ、エフィージオ
Egeo	エジェオ
Egidio	エジディオ、エジーディオ
Eleuterio	エレウテリオ、エレウテーリオ
Elia	エリア
Eligio	エリージョ
Elio	エリオ、エーリオ
Eliseo	エリゼオ
Elmo	エルモ
Elpidio	エルピディオ、エルピーディオ
Elvezio	エルヴェツィオ
Elvino	エルヴィーノ
Emanuele	エマヌエーレ
Emidio	エミディオ、エミーディオ
Emiliano	エミリアーノ
Emilio	エミリオ、エミーリオ
Emmanuele	エンマヌエーレ
Enea	エネーア
Ennio	エンニオ
Enrico	エンリコ、エンリーコ
Enzo	エンツォ
Epifanio	エピファーニオ
Eraldo	エラルド
Erardo	エラルド
Erasmo	エラズモ
Erberto	エルベルト
Ercole	エルコレ、エールコレ
Eriberto	エリベルト
Ermanno	エルマンノ
Ermenegildo	エルメネジルド
Ermete	エルメーテ
Erminio	エルミーニオ、エルミニオ
Ernesto	エルネスト
Ettore	エットレ
Eufemio	エウフェミオ
Eugenio	エウジェニオ、エウジェーニオ
Eusebio	エウゼビオ、エウゼービオ
Eustachio	エウスタキオ、エウスターキオ
Evaldo	エヴァルド
Evandro	エヴァンドロ
Evangelista	エヴァンジェリスタ
Evaristo	エヴァリスト
Everardo	エヴェラルド
Ezio	エッツィオ
Fabiano	ファビアーノ
Fabio	ファビオ
Fabrizio	ファブリツィオ
Faustino	ファウスティーノ
Fausto	ファウスト
Fazio	ファツィオ
Fedele	フェデーレ
Federico	フェデリーコ
Federigo	フェデリーゴ
Felice	フェリーチェ
Feliciano	フェリチャーノ
Ferdinando	フェルディナンド
Fermo	フェルモ
Ferruccio	フェッルッチョ、フェルルッチョ
Fidenzio	フィデンツィオ
Filiberto	フィリベルト
Filippo	フィリッポ
Filomeno	フィロメーノ
Fiorenzo	フィオレンツォ
Fiorino	フィオリーノ
Firmino	フィルミーノ
Flaminio	フラミニオ、フラミーニオ
Flaviano	フラヴィアーノ
Flavio	フラヴィオ、フラーヴィオ
Floriano	フロリアーノ
Fortunato	フォルトゥナート
Francesco	フランチェスコ
Franco	フランコ
Fulgenzio	フルジェンツィオ
Fulvio	フルヴィオ
Gabriele	ガブリエーレ
Gaetano	ガエターノ
Gaio	ガイオ
Galeazzo	ガレアッツォ
Galileo	ガリレオ
Gandolfo	ガンドルフォ
Gaspare	ガスパレ、ガースパレ
Gasparo	ガスパロ、ガースパロ
Gastone	ガストーネ
Gaudenzio	ガウデンツィオ
Gaudino	ガウディーノ
Gavino	ガヴィーノ
Genesio	ジェネジオ
Gennaro	ジェンナーロ
Gerardo	ジェラルド
Geremia	ジェレミア
Germano	ジェルマーノ、ジェルマノ
Gerolamo	ジェロラモ、ジェローラモ
Geronimo	ジェロニモ、ジェローニモ
Gervasio	ジェルヴァジオ、ジェルヴァージオ
Gesualdo	ジェズアルド
Giacinto	ジャチント
Giacobbe	ジャコッベ
Giacomo	ジャコモ、ジャーコモ
Giambattista	ジャンバッティスタ
Giampaolo	ジャンパオロ
Gian	ジャン
Gianantonio	ジャンアントニオ
Gianbattista	ジャンバッティスタ
Giancarlo	ジャンカルロ、ジャンカールロ
Giandomenico	ジャンドメニコ
Gianfranco	ジャンフランコ
Gianluca	ジャンルカ、ジャンルーカ
Gianluigi	ジャンルイージ
Gianmarco	ジャンマルコ
Gianmaria	ジャンマリア
Gianmario	ジャンマリオ
Gianni	ジャンニ
Giannino	ジャンニーノ
Gianpaolo	ジャンパオロ
Gianpiero	ジャンピエロ、ジャンピエーロ
Gianpietro	ジャンピエトロ
Gilberto	ジルベルト、ジルベールト
Gildo	ジルド
Gillo	ジッロ
Gino	ジーノ
Gioacchino	ジョアッキーノ
Gioachino	ジョアキーノ
Giocondo	ジョコンド
Gioele	ジョエレ、ジョエーレ
Gionata	ジョナタ
Giordano	ジョルダーノ
Giorgio	ジョルジョ
Giosuè	ジョズエ
Giotto	ジョット
Giovanni	ジョヴァンニ
Girardo	ジラルド
Girolamo	ジロラモ、ジローラモ
Giuliano	ジュリアーノ
Giulio	ジュリオ、ジューリオ
Giuseppe	ジュゼッペ
Giustiniano	ジュスティニアーノ、ジュスティニアノ
Giustino	ジュスティーノ
Giusto	ジュスト
Goffredo	ゴッフレード
Grato	グラート
Graziano	グラツィアーノ、グラッツィアーノ
Gregorio	グレゴリオ、グレゴーリオ
Gualtiero	グアルティエロ、グアルティエーロ
Guerrino	グエルリーノ
Guglielmo	グッリェルモ、グリエルモ
Guido	グイド
Gustavo	グスターヴォ
Ignazio	イニャーツィオ
Ilario	イラーリオ
Ildebrando	イルデブランド
Ildefonso	イルデフォンソ
Illuminato	イルミナート、イッルミナート
Innocente	インノチェンテ
Innocenzo	インノチェンツォ
Ippolito	イッポリト、イッポーリト
Ireneo	イレネオ
Isacco	イザッコ
Isaia	イザイア
Isidoro	イジドーロ
Italo	イタロ、イータロ
Ivano	イヴァーノ
Ivanoe	イヴァノエ
Ivo	イーヴォ
Jacopo	ヤコポ
Ladislao	ラディズラーオ
Lamberto	ランベルト
Landolfo	ランドルフォ
Lanfranco	ランフランコ
Lauro	ラウロ
Lazzaro	ラッザロ
Leandro	レアンドロ
Lelio	レリオ、レーリオ
Leonardo	レオナルド
Leone	レオネ、レオーネ
Leonida	レオニダ
Leonzio	レオンツィオ
Leopoldo	レオポルド
Letterio	レッテリオ、レッテーリオ
Liberato	リベラート
Liberatore	リベラトーレ
Liberio	リベリオ
Liberto	リベルト
Lidio	リディオ
Lieto	リエト
Lino	リーノ
Lionello	リオネッロ
Lisandro	リザンドロ
Livio	リヴィオ、リーヴィオ
Lodovico	ロドヴィーコ
Lorenzo	ロレンツォ
Lotario	ロターリオ
Luca	ルカ
Luchino	ルキーノ
Luciano	ルチャーノ
Lucio	ルーチョ
Lucrezio	ルクレツィオ
Ludovico	ルドヴィーコ
Luigi	ルイージ
Macario	マカーリオ
Maffeo	マッフェオ
Manfredo	マンフレード
Manlio	マンリオ
Manuel	マヌエル
Manuele	マヌエレ、マヌエーレ
Marcantonio	マルカントーニオ
Marcellino	マルチェッリーノ
Marcello	マルチェッロ（マルチェロ）
Marciano	マルチャーノ
Marco	マルコ
Mariano	マリアーノ
Marino	マリーノ
Mario	マリオ
Martino	マルティーノ
Marzio	マルツィオ
Massimiliano	マッシミリアーノ
Massimo	マッシモ
Matteo	マッテオ
Mattia	マッティア
Maurilio	マウリリオ、マウリーリオ
Maurizio	マウリツィオ
Mauro	マウロ
Medardo	メダルド
Melchiorre	メルキオッレ
Mercurio	メルクリオ
Michelangelo	ミケランジェロ
Michele	ミケーレ
Michelino	ミケリーノ
Milo	ミロ
Mirco	ミルコ
Mirko	ミルコ
Modesto	モデスト
Moreno	モレノ、モレーノ
Muzio	ムツィオ、ムーツィオ
Narciso	ナルチーゾ
Nazario	ナザリオ、ナザーリオ
Nereo	ネレーオ
Nerio	ネリオ、ネーリオ
Nero	ネーロ
Nestore	ネストレ
Niccolò	ニッコロ、ニコロ
Nico	ニーコ
Nicodemo	ニコデモ、ニコデーモ
Nicola	ニコラ、ニコーラ
Nicolò	ニコロ
Nino	ニーノ
Norberto	ノルベルト
Nunzio	ヌンツィオ
Olimpio	オリンピオ
Olindo	オリンド
Oliviero	オリヴィエーロ
Onesto	オネスト
Onofrio	オノフリオ
Orazio	オラツィオ、オラーツィオ
Oreste	オレステ
Orfeo	オルフェオ、オルフェーオ
Orlando	オルランド
Oscar	オスカル
Osvaldo	オズヴァルド
Ottaviano	オッタヴィアーノ
Ottavio	オッターヴィオ
Ottorino	オットリーノ
Ovidio	オヴィディオ
Palmiro	パルミロ、パルミーロ
Pancrazio	パンクラツィオ、パンクラーツィオ
Pantaleone	パンタレオーネ
Paolino	パオリーノ
Paolo	パオロ
Pasquale	パスクヮーレ
Patrizio	パトリツィオ
Pellegrino	ペッレグリーノ
Peppino	ペッピーノ
Pierangelo	ピエランジェロ
Piergiacomo	ピエルジャコモ
Pierluigi	ピエルルイジ、ピエルルイージ
Piermarco	ピエルマルコ
Piero	ピエロ
Pierpaolo	ピエルパオロ
Pietro	ピエトロ
Pino	ピーノ
Pio	ピオ、ピーオ
Pippo	ピッポ
Placido	プラチド
Plinio	プリーニオ
Pompeo	ポンペオ、ポンペーオ
Ponzio	ポンツィオ
Porfirio	ポルフィリオ、ポルフィーリオ
Primo	プリーモ
Prospero	プロスペロ
Publio	プブリオ
Quirino	クウィリーノ
Raffaele	ラファエーレ、ラッファエーレ
Raffaello	ラファエロ、ラッファエッロ
Raimondo	ライモンド
Raniero	ラニエロ
Raul	ラウル
Remigio	レミージョ
Remo	レーモ
Renato	レナート
Renzo	レンツォ、レンゾ
Riccardo	リッカルド
Rico	リコ
Rinaldo	リナルド
Roberto	ロベルト
Rocco	ロッコ
Rodolfo	ロドルフォ
Rodrigo	ロドリーゴ
Rolando	ロランド
Romano	ロマーノ
Romeo	ロメオ
Romolo	ロモロ
Rosario	ロザーリオ
Ruben	ルーベン
Rufino	ルフィーノ
Ruggero	ルッジェーロ
Ruggiero	ルッジエロ
Sabino	サビーノ
Saladino	サラディーノ
Salomone	サロモネ、サロモーネ
Salvatorangelo	サルヴァトーランジェロ
Salvatore	サルヴァトーレ
Samuele	サムエーレ、サムエレ
Sandro	サンドロ
Sansone	サンソーネ
Saturnino	サトゥルニーノ
Saverio	サヴェリオ、サヴェーリオ
Savino	サヴィーノ
Sebastiano	セバスティアーノ
Secondo	セコンド
Senofonte	セノフォンテ
Serafino	セラフィーノ
Sergio	セルジョ
Sesto	セスト
Severiano	セヴェリアーノ
Severino	セヴェリーノ
Severo	セヴェーロ
Sigismondo	シジズモンド
Silvano	シルヴァーノ
Silverio	シルヴェリオ
Silvestro	シルヴェストロ
Silvio	シルヴィオ
Simone	シモーネ
Sisto	シスト
Spano	スパーノ
Spartaco	スパルタコ
Stefano	ステファノ、ステーファノ
Taddeo	タッデオ
Tammaro	タンマーロ
Tarcisio	タルチジオ、タルチージオ
Tarquinio	タルクウィニオ、タルクウィーニオ
Tazio	タツィオ
Teo	テオ、テーオ
Teodoro	テオドーロ
Teodosio	テオドージオ
Teofilo	テオフィロ
Terenzio	テレンツィオ
Tiberio	ティベリオ
Timoteo	ティモテオ、ティモーテオ
Tino	ティーノ
Tito	ティト、ティート
Tiziano	ティツィアーノ
Tobia	トビア
Tomaso	トマーゾ
Tommaso	トンマーゾ
Tonio	トーニオ
Torquato	トルクヮート
Tranquillo	トランクウィッロ
Tristano	トリスターノ
Tullio	トゥッリオ、トゥーリオ
Ubaldo	ウバルド
Uberto	ウベルト
Ugo	ウーゴ
Ugolino	ウゴリーノ
Ulderico	ウルデリコ
Ulisse	ウリッセ
Umberto	ウンベルト
Urbano	ウルバーノ
Valente	ヴァレンテ
Valentino	ヴァレンティーノ、ヴァレンティノ
Valeriano	ヴァレリアーノ
Valerio	ヴァレリオ、ヴァレーリオ
Valfredo	ヴァルフレード
Vanni	ヴァンニ
Vasco	ヴァスコ
Venanzio	ヴェナンツィオ
Venceslao	ヴェンチェズラオ
Venerio	ヴェネリオ
Vespasiano	ヴェスパジアーノ
Vezio	ヴェッツィオ
Vigilio	ヴィジリオ
Vilfredo	ヴィルフレード
Vincenzo	ヴィンチェンツォ
Vinicio	ヴィニーチョ
Virgilio	ヴィルジーリオ、ヴィルジリオ
Vitale	ヴィターレ
Vito	ヴィート
Vittore	ヴィットーレ
Vittorio	ヴィットーリオ、ヴィットリオ