Aaron	アーロン
Abel	エイベル
Abraham	エイブラハム
Abram	エイブラム
Adam	アダム
Adolph	アドルフ
Adrian	エイドリアン
Alan	アラン
Alastair	アラスター（アラステア）
Albert	アルバート
Alex	アレックス
Alexander	アレグザンダー（アレクサンダー）
Alexis	アレクシス
Alf	アルフ
Alfie	アルフィー
Alfred	アルフレッド
Algernon	アルジャノン、アルジャーノン
Alistair	アリスター
Alister	アリスター
Allan	アラン
Allen	アレン
Allyn	アーリン
Alvin	アルヴィン
Ambrose	アンブローズ
Andrew	アンドルー（アンドリュー）
Andy	アンディ
Angus	アンガス
Anthony	アントニー、アンソニー
Anton	アントン
Antony	アントニー
Archibald	アーチボルド
Ariel	アリエル、エリアル
Arnold	アーノルド
Arthur	アーサー
Ashley	アシュリー
Ashton	アシュトン
Aubrey	オーブリー
August	オーガスト
Augustus	オーガスタス
Aylmer	エイルマー、エルマー
Baldwin	ボールドウィン
Barnaby	バーナビー
Barney	バーニー
Barry	バリー
Bartholomew	バーソロミュー
Basil	バージル、ベイジル
Ben	ベン
Benedict	ベネディクト
Benjamin	ベンジャミン
Bernard	バーナード
Bert	バート
Bertrand	バートランド
Bill	ビル
Billy	ビリー
Bob	ボブ
Bobby	ボビー
Brad	ブラッド
Bradford	ブラッドフォード
Bradley	ブラッドリー
Brandon	ブランドン
Brendan	ブレンダン
Brendon	ブレンドン
Brent	ブレント
Brett	ブレット
Brian	ブライアン
Bruce	ブルース
Bruno	ブルーノ
Bryan	ブライアン
Byron	バイロン
Calvin	カルヴィン、キャルヴィン
Cameron	キャメロン、カメロン
Carey	ケアリー、キャリー
Carl	カール
Carol	キャロル
Casey	ケイシー
Cecil	セシル
Cedric	セドリック
Chad	チャド
Charles	チャールズ
Charlie	チャーリー
Chester	チェスター
Chris	クリス
Christian	クリスティアン
Christopher	クリストファー
Clarence	クラレンス
Clark	クラーク
Cliff	クリフ
Clifford	クリフォード
Clifton	クリフトン
Clive	クライヴ
Clyde	クライド
Cody	コーディ
Colin	コリン
Conrad	コンラッド
Constant	コンスタント
Cornelius	コーニーリアス
Cory	コリー
Craig	クレイグ
Curtis	カーティス
Cyril	シリル
Cyrus	サイラス
Dale	デール
Damian	デイミアン
Damon	デイモン、デーモン
Dan	ダン
Daniel	ダニエル
Danny	ダニー
Darius	ダライアス
Darrell	ダレル
Darren	ダーレン、ダレン
Darryl	ダリル
Daryl	ダリル
Dave	デイヴ
David	デイヴィッド、デーヴィッド
Dean	ディーン
Denis	デニス
Dennis	デニス
Derek	デレク
Derick	デリック
Derrick	デリック
Deryck	デリック
Desmond	デズモンド
Dexter	デクスター
Dick	ディック
Dolph	ドルフ
Dom	ドム
Dominic	ドミニク
Don	ドン
Donald	ドナルド
Douglas	ダグラス
Drew	ドルー
Dudley	ダドリー
Duke	デューク
Duncan	ダンカン
Dustin	ダスティン
Dwayne	ドウェイン
Eamon	イーモン
Earl	アール
Eddie	エディー
Eddy	エディ
Eden	イーデン
Edgar	エドガー
Edmund	エドマンド
Edward	エドワード
Edwin	エドウィン
Egbert	エグバート
Eldred	エルドレッド
Elias	イライアス
Elijah	イライジャ
Elliot	エリオット
Elliott	エリオット
Ellis	エリス
Elmer	エルマー
Elton	エルトン
Elvis	エルヴィス
Emery	エメリー
Emmanuel	エマニュエル
Enoch	イーノック
Eric	エリック、エリク
Ernest	アーネスト
Ethan	イーサン
Ethelbert	エセルバート
Eugene	ユージーン、ユージン
Evan	エヴァン
Ewen	ユーイン
Fabian	フェイビアン
Felix	フェリックス
Ferdinand	ファーディナンド
Francis	フランシス
Frank	フランク
Franklin	フランクリン
Fred	フレッド
Freddie	フレディ
Frederick	フレドリック
Gabriel	ゲイブリエル
Gary	ギャリー、ゲイリー
Gene	ジーン
Geoff	ジェフ
Geoffrey	ジェフリー
George	ジョージ
Gerald	ジェラルド
Gerard	ジェラード
Gerry	ジェリー
Gideon	ギディオン、ギデオン
Gil	ギル
Gilbert	ギルバート
Giles	ジャイルズ
Glen	グレン
Glenn	グレン
Godfrey	ゴドフリー、ガドフリー
Godwin	ゴドウィン
Gordon	ゴードン
Graham	グレアム、グレイアム
Grantley	グラントリー
Greg	グレッグ
Gregory	グレゴリー
Gus	ガス
Guy	ガイ
Hadley	ハドリー
Hamilton	ハミルトン
Harold	ハロルド
Harrison	ハリスン、ハリソン
Harry	ハリー
Harvey	ハーヴィー（ハーヴェイ）
Hayden	ヘイデン
Hector	ヘクター
Henry	ヘンリー
Herbert	ハーバート
Herman	ハーマン
Hilary	ヒラリー
Horace	ホレス
Horatio	ホレイシオ、ホレイショー
Howard	ハワード
Hubert	ヒューバート
Hugh	ヒュー
Hugo	ヒューゴー
Humphrey	ハンフリー
Ian	イアン
Irvine	アーヴィン、アーヴァイン
Irving	アーヴィング
Isaac	アイザック
Ivan	アイヴァン
Jack	ジャック
Jackie	ジャッキー
Jackson	ジャクソン
Jacob	ジェイコブ
Jairus	ジェイラス
Jake	ジェイク
James	ジェームズ
Jamie	ジェイミー
Jared	ジャレッド
Jason	ジェイソン
Jasper	ジャスパー
Jeff	ジェフ
Jeffery	ジェフリー
Jeffrey	ジェフリー
Jeremiah	ジェレマイア
Jeremy	ジェレミー
Jerome	ジェローム
Jerry	ジェリー
Jesse	ジェシー
Jim	ジム
Jimmie	ジミー
Jimmy	ジミー
Jocelyn	ジョスリン
Joel	ジョール、ジョエル
John	ジョン
Johnny	ジョニー
Jon	ジョン
Jonas	ジョナス
Jonathan	ジョナサン
Jordan	ジョーダン
Joseph	ジョーセフ
Josh	ジョッシュ
Joshua	ジョシュア
Josiah	ジョザイア
Jude	ジュード
Julian	ジュリアン
Justin	ジャスティン
Keith	キース
Kenneth	ケネス
Kent	ケント
Kevin	ケヴィン
Kim	キム
Kyle	カイル
Landon	ランドン
Laurence	ローレンス
Lawrence	ローレンス
Lee	リー
Leo	リオ（レオ）
Leon	リオン（レオン）
Leonard	レナード
Leslie	レスリー、レズリー
Lester	レスター
Levi	リーヴァイ
Lewis	ルイス
Lex	レックス
Liam	リーアム、リアム
Lindsay	リンジー
Lindsey	リンジー
Linus	ライナス
Lionel	ライオネル
Lloyd	ロイド
Lonnie	ロニー
Louis	ルイス
Lucas	ルーカス
Lucian	ルーシャン、ルシアン
Luke	ルーク
Luther	ルーサー
Malcolm	マルコム
Manuel	マヌエル
Marcus	マーカス
Mark	マーク
Martin	マーティン
Marty	マーティー
Marvin	マーヴィン
Mathew	マシュー
Matthew	マシュー
Maurice	モーリス
Max	マックス
Maximilian	マクシミリアン
Maynard	メイナード
Melvin	メルヴィン
Meredith	メレディス
Michael	マイケル
Mick	ミック
Mickey	ミッキー
Micky	ミッキー
Mike	マイク
Miles	マイルズ
Mitchell	ミッチェル
Montague	モンタギュー
Morgan	モーガン
Morris	モーリス
Moses	モージズ、モーゼズ
Myles	マイルズ
Nate	ネイト
Nathan	ネイサン
Nathaniel	ナサニエル
Neil	ニール
Nicholas	ニコラス
Nick	ニック
Nicolas	ニコラス
Nigel	ナイジェル
Noah	ノア
Noel	ノエル
Norman	ノーマン
Oliver	オリヴァー
Oscar	オスカー
Oswald	オズワルド
Othniel	オスニエル
Owen	オーウェン、オーエン
Pascal	パスカル
Pat	パット
Patrick	パトリック
Paul	ポール
Perceval	パーシヴァル
Percival	パーシヴァル
Percy	パーシー
Peter	ピーター
Phil	フィル
Philander	フィランダー
Philip	フィリップ
Phillip	フィリップ
Quentin	クェンティン
Quincy	クィンシー
Rafe	レイフ
Ralph	レイフ、ラルフ
Randall	ランドル
Randolf	ランドルフ
Randolph	ランドルフ
Randy	ランディー
Raphael	ラフェエル
Ray	レイ
Raymond	レイモンド
Reginald	レジナルド
Rex	レックス
Reynold	レナルド
Richard	リチャード
Rick	リック
Ricky	リッキー
Rob	ロブ
Robert	ロバート
Robin	ロビン
Roderick	ロードリック
Rodger	ロジャー
Rodney	ロドニー
Roger	ロジャー
Roland	ローランド
Roman	ローマン
Ronald	ロナルド
Ronnie	ロニー
Rowland	ローランド
Roy	ロイ
Rufus	ルーファス
Rupert	ルパート、ルーパート
Russel	ラッセル
Russell	ラッセル
Sam	サム
Sammy	サミー
Samuel	サミュエル
Sandy	サンディー
Scott	スコット
Sebastian	セバスチャン
Shaun	ショーン
Sidney	シドニー
Silas	サイラス
Silvester	シルヴェスター
Simeon	シミオン
Simon	サイモン
Solomon	ソロモン
Spencer	スペンサー
Stanley	スタンリー
Stephen	スティーヴン
Steve	スティーヴ
Steven	スティーヴン
Stevie	スティーヴィー
Stewart	スチュアート
Stuart	スチュアート
Sylvester	シルヴェスター
Ted	テッド
Teddy	テディ、テディー
Terence	テレンス
Terrence	テレンス
Terry	テリー
Thaddeus	サディアス
Theodore	シオドア、セオドア
Theodoric	シオドリック、セオドリック
Thom	トム
Thomas	トーマス、トマス
Tim	ティム
Timothy	ティモシー
Tobias	トバイアス
Toby	トビー
Tom	トム
Tommy	トミー
Tony	トニー
Tracy	トレイシー、トレーシー
Travis	トラヴィス
Trevor	トレヴァー
Tristan	トリスタン
Ulysses	ユリシーズ
Valentine	ヴァレンタイン
Victor	ヴィクター
Vince	ヴィンス
Vincent	ヴィンセント
Virgil	ヴァージル
Vivian	ヴィヴィアン
Wallace	ウォーレス
Walt	ウォルト
Walter	ウォルター
Warren	ウォーレン
Wesley	ウェズリー、ウェスリー
Wilfred	ウィルフレッド
William	ウィリアム
Winston	ウィンストン
Zachariah	ザカライア
Zachary	ザカリー
Zechariah	ザカライア